Name,Description,all_houston_zips,AREALAND_ZCTA5_20,AREAWATER_ZCTA5_20,pop_2020,aland_acre,awater_acre,total_area,total_area_acre
<at><openparen>77002<closeparen>,"<center><table><tr><th colspan='2' align='center'><em>Attributes</em></th></tr><tr bgcolor=""#E3E3F3""> <th>ZCTA5CE20</th> <td>77002</td> </tr><tr bgcolor=""""> <th>AFFGEOID20</th> <td>860Z200US77002</td> </tr><tr bgcolor=""#E3E3F3""> <th>GEOID20</th> <td>77002</td> </tr><tr bgcolor=""""> <th>NAME20</th> <td>77002</td> </tr><tr bgcolor=""#E3E3F3""> <th>LSAD20</th> <td>Z5</td> </tr><tr bgcolor=""""> <th>ALAND20</th> <td>5101447</td> </tr><tr bgcolor=""#E3E3F3""> <th>AWATER20</th> <td>114561</td> </tr></table></center>",77002,5101447,114561,"19844",1260.55028416111,28.3076352853966,5216008,1288.8579194465
<at><openparen>77003<closeparen>,"<center><table><tr><th colspan='2' align='center'><em>Attributes</em></th></tr><tr bgcolor=""#E3E3F3""> <th>ZCTA5CE20</th> <td>77003</td> </tr><tr bgcolor=""""> <th>AFFGEOID20</th> <td>860Z200US77003</td> </tr><tr bgcolor=""#E3E3F3""> <th>GEOID20</th> <td>77003</td> </tr><tr bgcolor=""""> <th>NAME20</th> <td>77003</td> </tr><tr bgcolor=""#E3E3F3""> <th>LSAD20</th> <td>Z5</td> </tr><tr bgcolor=""""> <th>ALAND20</th> <td>7080393</td> </tr><tr bgcolor=""#E3E3F3""> <th>AWATER20</th> <td>86240</td> </tr></table></center>",77003,7080393,86240,"11874",1749.54114158636,21.3096120583148,7166633,1770.85075364468
<at><openparen>77004<closeparen>,"<center><table><tr><th colspan='2' align='center'><em>Attributes</em></th></tr><tr bgcolor=""#E3E3F3""> <th>ZCTA5CE20</th> <td>77004</td> </tr><tr bgcolor=""""> <th>AFFGEOID20</th> <td>860Z200US77004</td> </tr><tr bgcolor=""#E3E3F3""> <th>GEOID20</th> <td>77004</td> </tr><tr bgcolor=""""> <th>NAME20</th> <td>77004</td> </tr><tr bgcolor=""#E3E3F3""> <th>LSAD20</th> <td>Z5</td> </tr><tr bgcolor=""""> <th>ALAND20</th> <td>13574107</td> </tr><tr bgcolor=""#E3E3F3""> <th>AWATER20</th> <td>63296</td> </tr></table></center>",77004,13574107,63296,"37005",3354.11588831233,15.6402273288856,13637403,3369.75611564122
<at><openparen>77005<closeparen>,"<center><table><tr><th colspan='2' align='center'><em>Attributes</em></th></tr><tr bgcolor=""#E3E3F3""> <th>ZCTA5CE20</th> <td>77005</td> </tr><tr bgcolor=""""> <th>AFFGEOID20</th> <td>860Z200US77005</td> </tr><tr bgcolor=""#E3E3F3""> <th>GEOID20</th> <td>77005</td> </tr><tr bgcolor=""""> <th>NAME20</th> <td>77005</td> </tr><tr bgcolor=""#E3E3F3""> <th>LSAD20</th> <td>Z5</td> </tr><tr bgcolor=""""> <th>ALAND20</th> <td>9914812</td> </tr><tr bgcolor=""#E3E3F3""> <th>AWATER20</th> <td>720</td> </tr></table></center>",77005,9914812,720,"28241",2449.91648134421,0.177909562638992,9915532,2450.09439090684
<at><openparen>77006<closeparen>,"<center><table><tr><th colspan='2' align='center'><em>Attributes</em></th></tr><tr bgcolor=""#E3E3F3""> <th>ZCTA5CE20</th> <td>77006</td> </tr><tr bgcolor=""""> <th>AFFGEOID20</th> <td>860Z200US77006</td> </tr><tr bgcolor=""#E3E3F3""> <th>GEOID20</th> <td>77006</td> </tr><tr bgcolor=""""> <th>NAME20</th> <td>77006</td> </tr><tr bgcolor=""#E3E3F3""> <th>LSAD20</th> <td>Z5</td> </tr><tr bgcolor=""""> <th>ALAND20</th> <td>5932367</td> </tr><tr bgcolor=""#E3E3F3""> <th>AWATER20</th> <td>0</td> </tr></table></center>",77006,5932367,0,"24129",1465.86780331109,0,5932367,1465.86780331109
<at><openparen>77007<closeparen>,"<center><table><tr><th colspan='2' align='center'><em>Attributes</em></th></tr><tr bgcolor=""#E3E3F3""> <th>ZCTA5CE20</th> <td>77007</td> </tr><tr bgcolor=""""> <th>AFFGEOID20</th> <td>860Z200US77007</td> </tr><tr bgcolor=""#E3E3F3""> <th>GEOID20</th> <td>77007</td> </tr><tr bgcolor=""""> <th>NAME20</th> <td>77007</td> </tr><tr bgcolor=""#E3E3F3""> <th>LSAD20</th> <td>Z5</td> </tr><tr bgcolor=""""> <th>ALAND20</th> <td>19443074</td> </tr><tr bgcolor=""#E3E3F3""> <th>AWATER20</th> <td>221212</td> </tr></table></center>",77007,19443074,221212,"42908",4804.3177662466,54.660736347912,19664286,4858.97850259451
<at><openparen>77008<closeparen>,"<center><table><tr><th colspan='2' align='center'><em>Attributes</em></th></tr><tr bgcolor=""#E3E3F3""> <th>ZCTA5CE20</th> <td>77008</td> </tr><tr bgcolor=""""> <th>AFFGEOID20</th> <td>860Z200US77008</td> </tr><tr bgcolor=""#E3E3F3""> <th>GEOID20</th> <td>77008</td> </tr><tr bgcolor=""""> <th>NAME20</th> <td>77008</td> </tr><tr bgcolor=""#E3E3F3""> <th>LSAD20</th> <td>Z5</td> </tr><tr bgcolor=""""> <th>ALAND20</th> <td>16784687</td> </tr><tr bgcolor=""#E3E3F3""> <th>AWATER20</th> <td>70549</td> </tr></table></center>",77008,16784687,70549,"36631",4147.43933778107,17.4324190758587,16855236,4164.87175685693
<at><openparen>77009<closeparen>,"<center><table><tr><th colspan='2' align='center'><em>Attributes</em></th></tr><tr bgcolor=""#E3E3F3""> <th>ZCTA5CE20</th> <td>77009</td> </tr><tr bgcolor=""""> <th>AFFGEOID20</th> <td>860Z200US77009</td> </tr><tr bgcolor=""#E3E3F3""> <th>GEOID20</th> <td>77009</td> </tr><tr bgcolor=""""> <th>NAME20</th> <td>77009</td> </tr><tr bgcolor=""#E3E3F3""> <th>LSAD20</th> <td>Z5</td> </tr><tr bgcolor=""""> <th>ALAND20</th> <td>16046120</td> </tr><tr bgcolor=""#E3E3F3""> <th>AWATER20</th> <td>21754</td> </tr></table></center>",77009,16046120,21754,"36425",3964.94193229553,5.37533975784532,16067874,3970.31727205337
<at><openparen>77010<closeparen>,"<center><table><tr><th colspan='2' align='center'><em>Attributes</em></th></tr><tr bgcolor=""#E3E3F3""> <th>ZCTA5CE20</th> <td>77010</td> </tr><tr bgcolor=""""> <th>AFFGEOID20</th> <td>860Z200US77010</td> </tr><tr bgcolor=""#E3E3F3""> <th>GEOID20</th> <td>77010</td> </tr><tr bgcolor=""""> <th>NAME20</th> <td>77010</td> </tr><tr bgcolor=""#E3E3F3""> <th>LSAD20</th> <td>Z5</td> </tr><tr bgcolor=""""> <th>ALAND20</th> <td>309333</td> </tr><tr bgcolor=""#E3E3F3""> <th>AWATER20</th> <td>0</td> </tr></table></center>",77010,309333,0,"883",76.4351371386212,0,309333,76.4351371386212
<at><openparen>77011<closeparen>,"<center><table><tr><th colspan='2' align='center'><em>Attributes</em></th></tr><tr bgcolor=""#E3E3F3""> <th>ZCTA5CE20</th> <td>77011</td> </tr><tr bgcolor=""""> <th>AFFGEOID20</th> <td>860Z200US77011</td> </tr><tr bgcolor=""#E3E3F3""> <th>GEOID20</th> <td>77011</td> </tr><tr bgcolor=""""> <th>NAME20</th> <td>77011</td> </tr><tr bgcolor=""#E3E3F3""> <th>LSAD20</th> <td>Z5</td> </tr><tr bgcolor=""""> <th>ALAND20</th> <td>8832833</td> </tr><tr bgcolor=""#E3E3F3""> <th>AWATER20</th> <td>400260</td> </tr></table></center>",77011,8832833,400260,"16841",2182.56313318508,98.9028910303929,9233093,2281.46602421547
<at><openparen>77012<closeparen>,"<center><table><tr><th colspan='2' align='center'><em>Attributes</em></th></tr><tr bgcolor=""#E3E3F3""> <th>ZCTA5CE20</th> <td>77012</td> </tr><tr bgcolor=""""> <th>AFFGEOID20</th> <td>860Z200US77012</td> </tr><tr bgcolor=""#E3E3F3""> <th>GEOID20</th> <td>77012</td> </tr><tr bgcolor=""""> <th>NAME20</th> <td>77012</td> </tr><tr bgcolor=""#E3E3F3""> <th>LSAD20</th> <td>Z5</td> </tr><tr bgcolor=""""> <th>ALAND20</th> <td>10183964</td> </tr><tr bgcolor=""#E3E3F3""> <th>AWATER20</th> <td>810501</td> </tr></table></center>",77012,10183964,810501,"18397",2516.4230294045,200.272053372869,10994465,2716.69508277737
<at><openparen>77013<closeparen>,"<center><table><tr><th colspan='2' align='center'><em>Attributes</em></th></tr><tr bgcolor=""#E3E3F3""> <th>ZCTA5CE20</th> <td>77013</td> </tr><tr bgcolor=""""> <th>AFFGEOID20</th> <td>860Z200US77013</td> </tr><tr bgcolor=""#E3E3F3""> <th>GEOID20</th> <td>77013</td> </tr><tr bgcolor=""""> <th>NAME20</th> <td>77013</td> </tr><tr bgcolor=""#E3E3F3""> <th>LSAD20</th> <td>Z5</td> </tr><tr bgcolor=""""> <th>ALAND20</th> <td>24564994</td> </tr><tr bgcolor=""#E3E3F3""> <th>AWATER20</th> <td>193468</td> </tr></table></center>",77013,24564994,193468,"16815",6069.92685940203,47.8052878675562,24758462,6117.73214726958
<at><openparen>77014<closeparen>,"<center><table><tr><th colspan='2' align='center'><em>Attributes</em></th></tr><tr bgcolor=""#E3E3F3""> <th>ZCTA5CE20</th> <td>77014</td> </tr><tr bgcolor=""""> <th>AFFGEOID20</th> <td>860Z200US77014</td> </tr><tr bgcolor=""#E3E3F3""> <th>GEOID20</th> <td>77014</td> </tr><tr bgcolor=""""> <th>NAME20</th> <td>77014</td> </tr><tr bgcolor=""#E3E3F3""> <th>LSAD20</th> <td>Z5</td> </tr><tr bgcolor=""""> <th>ALAND20</th> <td>18582699</td> </tr><tr bgcolor=""#E3E3F3""> <th>AWATER20</th> <td>29539</td> </tr></table></center>",77014,18582699,29539,"35161",4591.72201630838,7.29898690387942,18612238,4599.02100321226
<at><openparen>77015<closeparen>,"<center><table><tr><th colspan='2' align='center'><em>Attributes</em></th></tr><tr bgcolor=""#E3E3F3""> <th>ZCTA5CE20</th> <td>77015</td> </tr><tr bgcolor=""""> <th>AFFGEOID20</th> <td>860Z200US77015</td> </tr><tr bgcolor=""#E3E3F3""> <th>GEOID20</th> <td>77015</td> </tr><tr bgcolor=""""> <th>NAME20</th> <td>77015</td> </tr><tr bgcolor=""#E3E3F3""> <th>LSAD20</th> <td>Z5</td> </tr><tr bgcolor=""""> <th>ALAND20</th> <td>53487053</td> </tr><tr bgcolor=""#E3E3F3""> <th>AWATER20</th> <td>5193097</td> </tr></table></center>",77015,53487053,5193097,"57106",13216.4697306647,1283.19668890536,58680150,14499.6664195701
<at><openparen>77016<closeparen>,"<center><table><tr><th colspan='2' align='center'><em>Attributes</em></th></tr><tr bgcolor=""#E3E3F3""> <th>ZCTA5CE20</th> <td>77016</td> </tr><tr bgcolor=""""> <th>AFFGEOID20</th> <td>860Z200US77016</td> </tr><tr bgcolor=""#E3E3F3""> <th>GEOID20</th> <td>77016</td> </tr><tr bgcolor=""""> <th>NAME20</th> <td>77016</td> </tr><tr bgcolor=""#E3E3F3""> <th>LSAD20</th> <td>Z5</td> </tr><tr bgcolor=""""> <th>ALAND20</th> <td>25664998</td> </tr><tr bgcolor=""#E3E3F3""> <th>AWATER20</th> <td>114515</td> </tr></table></center>",77016,25664998,114515,"29966",6341.7341240425,28.2962688411169,25779513,6370.03039288362
<at><openparen>77017<closeparen>,"<center><table><tr><th colspan='2' align='center'><em>Attributes</em></th></tr><tr bgcolor=""#E3E3F3""> <th>ZCTA5CE20</th> <td>77017</td> </tr><tr bgcolor=""""> <th>AFFGEOID20</th> <td>860Z200US77017</td> </tr><tr bgcolor=""#E3E3F3""> <th>GEOID20</th> <td>77017</td> </tr><tr bgcolor=""""> <th>NAME20</th> <td>77017</td> </tr><tr bgcolor=""#E3E3F3""> <th>LSAD20</th> <td>Z5</td> </tr><tr bgcolor=""""> <th>ALAND20</th> <td>24792377</td> </tr><tr bgcolor=""#E3E3F3""> <th>AWATER20</th> <td>1088249</td> </tr></table></center>",77017,24792377,1088249,"31659",6126.11242895972,268.902643933778,25880626,6395.0150728935
<at><openparen>77018<closeparen>,"<center><table><tr><th colspan='2' align='center'><em>Attributes</em></th></tr><tr bgcolor=""#E3E3F3""> <th>ZCTA5CE20</th> <td>77018</td> </tr><tr bgcolor=""""> <th>AFFGEOID20</th> <td>860Z200US77018</td> </tr><tr bgcolor=""#E3E3F3""> <th>GEOID20</th> <td>77018</td> </tr><tr bgcolor=""""> <th>NAME20</th> <td>77018</td> </tr><tr bgcolor=""#E3E3F3""> <th>LSAD20</th> <td>Z5</td> </tr><tr bgcolor=""""> <th>ALAND20</th> <td>17527254</td> </tr><tr bgcolor=""#E3E3F3""> <th>AWATER20</th> <td>39114</td> </tr></table></center>",77018,17527254,39114,"27870",4330.92512972572,9.66493699036323,17566368,4340.59006671609
<at><openparen>77019<closeparen>,"<center><table><tr><th colspan='2' align='center'><em>Attributes</em></th></tr><tr bgcolor=""#E3E3F3""> <th>ZCTA5CE20</th> <td>77019</td> </tr><tr bgcolor=""""> <th>AFFGEOID20</th> <td>860Z200US77019</td> </tr><tr bgcolor=""#E3E3F3""> <th>GEOID20</th> <td>77019</td> </tr><tr bgcolor=""""> <th>NAME20</th> <td>77019</td> </tr><tr bgcolor=""#E3E3F3""> <th>LSAD20</th> <td>Z5</td> </tr><tr bgcolor=""""> <th>ALAND20</th> <td>9596265</td> </tr><tr bgcolor=""#E3E3F3""> <th>AWATER20</th> <td>132078</td> </tr></table></center>",77019,9596265,132078,"24136",2371.20459599703,32.6360266864344,9728343,2403.84062268347
<at><openparen>77020<closeparen>,"<center><table><tr><th colspan='2' align='center'><em>Attributes</em></th></tr><tr bgcolor=""#E3E3F3""> <th>ZCTA5CE20</th> <td>77020</td> </tr><tr bgcolor=""""> <th>AFFGEOID20</th> <td>860Z200US77020</td> </tr><tr bgcolor=""#E3E3F3""> <th>GEOID20</th> <td>77020</td> </tr><tr bgcolor=""""> <th>NAME20</th> <td>77020</td> </tr><tr bgcolor=""#E3E3F3""> <th>LSAD20</th> <td>Z5</td> </tr><tr bgcolor=""""> <th>ALAND20</th> <td>20226280</td> </tr><tr bgcolor=""#E3E3F3""> <th>AWATER20</th> <td>751424</td> </tr></table></center>",77020,20226280,751424,"24846",4997.84531751915,185.674326661725,20977704,5183.51964418087
<at><openparen>77021<closeparen>,"<center><table><tr><th colspan='2' align='center'><em>Attributes</em></th></tr><tr bgcolor=""#E3E3F3""> <th>ZCTA5CE20</th> <td>77021</td> </tr><tr bgcolor=""""> <th>AFFGEOID20</th> <td>860Z200US77021</td> </tr><tr bgcolor=""#E3E3F3""> <th>GEOID20</th> <td>77021</td> </tr><tr bgcolor=""""> <th>NAME20</th> <td>77021</td> </tr><tr bgcolor=""#E3E3F3""> <th>LSAD20</th> <td>Z5</td> </tr><tr bgcolor=""""> <th>ALAND20</th> <td>15738375</td> </tr><tr bgcolor=""#E3E3F3""> <th>AWATER20</th> <td>65109</td> </tr></table></center>",77021,15738375,65109,"28055",3888.89918458117,16.0882134914752,15803484,3904.98739807265
<at><openparen>77022<closeparen>,"<center><table><tr><th colspan='2' align='center'><em>Attributes</em></th></tr><tr bgcolor=""#E3E3F3""> <th>ZCTA5CE20</th> <td>77022</td> </tr><tr bgcolor=""""> <th>AFFGEOID20</th> <td>860Z200US77022</td> </tr><tr bgcolor=""#E3E3F3""> <th>GEOID20</th> <td>77022</td> </tr><tr bgcolor=""""> <th>NAME20</th> <td>77022</td> </tr><tr bgcolor=""#E3E3F3""> <th>LSAD20</th> <td>Z5</td> </tr><tr bgcolor=""""> <th>ALAND20</th> <td>15128810</td> </tr><tr bgcolor=""#E3E3F3""> <th>AWATER20</th> <td>1147</td> </tr></table></center>",77022,15128810,1147,"28748",3738.27773659501,0.283419817148505,15129957,3738.56115641216
<at><openparen>77023<closeparen>,"<center><table><tr><th colspan='2' align='center'><em>Attributes</em></th></tr><tr bgcolor=""#E3E3F3""> <th>ZCTA5CE20</th> <td>77023</td> </tr><tr bgcolor=""""> <th>AFFGEOID20</th> <td>860Z200US77023</td> </tr><tr bgcolor=""#E3E3F3""> <th>GEOID20</th> <td>77023</td> </tr><tr bgcolor=""""> <th>NAME20</th> <td>77023</td> </tr><tr bgcolor=""#E3E3F3""> <th>LSAD20</th> <td>Z5</td> </tr><tr bgcolor=""""> <th>ALAND20</th> <td>14159580</td> </tr><tr bgcolor=""#E3E3F3""> <th>AWATER20</th> <td>233418</td> </tr></table></center>",77023,14159580,233418,"26780",3498.7842846553,57.6767976278725,14392998,3556.46108228317
<at><openparen>77024<closeparen>,"<center><table><tr><th colspan='2' align='center'><em>Attributes</em></th></tr><tr bgcolor=""#E3E3F3""> <th>ZCTA5CE20</th> <td>77024</td> </tr><tr bgcolor=""""> <th>AFFGEOID20</th> <td>860Z200US77024</td> </tr><tr bgcolor=""#E3E3F3""> <th>GEOID20</th> <td>77024</td> </tr><tr bgcolor=""""> <th>NAME20</th> <td>77024</td> </tr><tr bgcolor=""#E3E3F3""> <th>LSAD20</th> <td>Z5</td> </tr><tr bgcolor=""""> <th>ALAND20</th> <td>33594314</td> </tr><tr bgcolor=""#E3E3F3""> <th>AWATER20</th> <td>88945</td> </tr></table></center>",77024,33594314,88945,"39565",8301.04126513467,21.9780084012849,33683259,8323.01927353595
<at><openparen>77025<closeparen>,"<center><table><tr><th colspan='2' align='center'><em>Attributes</em></th></tr><tr bgcolor=""#E3E3F3""> <th>ZCTA5CE20</th> <td>77025</td> </tr><tr bgcolor=""""> <th>AFFGEOID20</th> <td>860Z200US77025</td> </tr><tr bgcolor=""#E3E3F3""> <th>GEOID20</th> <td>77025</td> </tr><tr bgcolor=""""> <th>NAME20</th> <td>77025</td> </tr><tr bgcolor=""#E3E3F3""> <th>LSAD20</th> <td>Z5</td> </tr><tr bgcolor=""""> <th>ALAND20</th> <td>11557391</td> </tr><tr bgcolor=""#E3E3F3""> <th>AWATER20</th> <td>89314</td> </tr></table></center>",77025,11557391,89314,"28510",2855.79219174697,22.0691870521374,11646705,2877.86137879911
<at><openparen>77026<closeparen>,"<center><table><tr><th colspan='2' align='center'><em>Attributes</em></th></tr><tr bgcolor=""#E3E3F3""> <th>ZCTA5CE20</th> <td>77026</td> </tr><tr bgcolor=""""> <th>AFFGEOID20</th> <td>860Z200US77026</td> </tr><tr bgcolor=""#E3E3F3""> <th>GEOID20</th> <td>77026</td> </tr><tr bgcolor=""""> <th>NAME20</th> <td>77026</td> </tr><tr bgcolor=""#E3E3F3""> <th>LSAD20</th> <td>Z5</td> </tr><tr bgcolor=""""> <th>ALAND20</th> <td>16992291</td> </tr><tr bgcolor=""#E3E3F3""> <th>AWATER20</th> <td>1056</td> </tr></table></center>",77026,16992291,1056,"23405",4198.73758339511,0.260934025203855,16993347,4198.99851742031
<at><openparen>77027<closeparen>,"<center><table><tr><th colspan='2' align='center'><em>Attributes</em></th></tr><tr bgcolor=""#E3E3F3""> <th>ZCTA5CE20</th> <td>77027</td> </tr><tr bgcolor=""""> <th>AFFGEOID20</th> <td>860Z200US77027</td> </tr><tr bgcolor=""#E3E3F3""> <th>GEOID20</th> <td>77027</td> </tr><tr bgcolor=""""> <th>NAME20</th> <td>77027</td> </tr><tr bgcolor=""#E3E3F3""> <th>LSAD20</th> <td>Z5</td> </tr><tr bgcolor=""""> <th>ALAND20</th> <td>6899514</td> </tr><tr bgcolor=""#E3E3F3""> <th>AWATER20</th> <td>11567</td> </tr></table></center>",77027,6899514,11567,"18987",1704.84655300222,2.85816654311836,6911081,1707.70471954534
<at><openparen>77028<closeparen>,"<center><table><tr><th colspan='2' align='center'><em>Attributes</em></th></tr><tr bgcolor=""#E3E3F3""> <th>ZCTA5CE20</th> <td>77028</td> </tr><tr bgcolor=""""> <th>AFFGEOID20</th> <td>860Z200US77028</td> </tr><tr bgcolor=""#E3E3F3""> <th>GEOID20</th> <td>77028</td> </tr><tr bgcolor=""""> <th>NAME20</th> <td>77028</td> </tr><tr bgcolor=""#E3E3F3""> <th>LSAD20</th> <td>Z5</td> </tr><tr bgcolor=""""> <th>ALAND20</th> <td>23594391</td> </tr><tr bgcolor=""#E3E3F3""> <th>AWATER20</th> <td>20809</td> </tr></table></center>",77028,23594391,20809,"18701",5830.09414381023,5.14183345688164,23615200,5835.23597726711
<at><openparen>77029<closeparen>,"<center><table><tr><th colspan='2' align='center'><em>Attributes</em></th></tr><tr bgcolor=""#E3E3F3""> <th>ZCTA5CE20</th> <td>77029</td> </tr><tr bgcolor=""""> <th>AFFGEOID20</th> <td>860Z200US77029</td> </tr><tr bgcolor=""#E3E3F3""> <th>GEOID20</th> <td>77029</td> </tr><tr bgcolor=""""> <th>NAME20</th> <td>77029</td> </tr><tr bgcolor=""#E3E3F3""> <th>LSAD20</th> <td>Z5</td> </tr><tr bgcolor=""""> <th>ALAND20</th> <td>27495741</td> </tr><tr bgcolor=""#E3E3F3""> <th>AWATER20</th> <td>700870</td> </tr></table></center>",77029,27495741,700870,"17044",6794.10452186805,173.18260439832,28196611,6967.28712626637
<at><openparen>77030<closeparen>,"<center><table><tr><th colspan='2' align='center'><em>Attributes</em></th></tr><tr bgcolor=""#E3E3F3""> <th>ZCTA5CE20</th> <td>77030</td> </tr><tr bgcolor=""""> <th>AFFGEOID20</th> <td>860Z200US77030</td> </tr><tr bgcolor=""#E3E3F3""> <th>GEOID20</th> <td>77030</td> </tr><tr bgcolor=""""> <th>NAME20</th> <td>77030</td> </tr><tr bgcolor=""#E3E3F3""> <th>LSAD20</th> <td>Z5</td> </tr><tr bgcolor=""""> <th>ALAND20</th> <td>6684885</td> </tr><tr bgcolor=""#E3E3F3""> <th>AWATER20</th> <td>129898</td> </tr></table></center>",77030,6684885,129898,"13221",1651.81245366938,32.0973560662219,6814783,1683.90980973561
<at><openparen>77031<closeparen>,"<center><table><tr><th colspan='2' align='center'><em>Attributes</em></th></tr><tr bgcolor=""#E3E3F3""> <th>ZCTA5CE20</th> <td>77031</td> </tr><tr bgcolor=""""> <th>AFFGEOID20</th> <td>860Z200US77031</td> </tr><tr bgcolor=""#E3E3F3""> <th>GEOID20</th> <td>77031</td> </tr><tr bgcolor=""""> <th>NAME20</th> <td>77031</td> </tr><tr bgcolor=""#E3E3F3""> <th>LSAD20</th> <td>Z5</td> </tr><tr bgcolor=""""> <th>ALAND20</th> <td>8175764</td> </tr><tr bgcolor=""#E3E3F3""> <th>AWATER20</th> <td>18564</td> </tr></table></center>",77031,8175764,18564,"15678",2020.20360761058,4.58710155670867,8194328,2024.79070916728
<at><openparen>77032<closeparen>,"<center><table><tr><th colspan='2' align='center'><em>Attributes</em></th></tr><tr bgcolor=""#E3E3F3""> <th>ZCTA5CE20</th> <td>77032</td> </tr><tr bgcolor=""""> <th>AFFGEOID20</th> <td>860Z200US77032</td> </tr><tr bgcolor=""#E3E3F3""> <th>GEOID20</th> <td>77032</td> </tr><tr bgcolor=""""> <th>NAME20</th> <td>77032</td> </tr><tr bgcolor=""#E3E3F3""> <th>LSAD20</th> <td>Z5</td> </tr><tr bgcolor=""""> <th>ALAND20</th> <td>59820859</td> </tr><tr bgcolor=""#E3E3F3""> <th>AWATER20</th> <td>84806</td> </tr></table></center>",77032,59820859,84806,"13497",14781.531751915,20.9552755127255,59905665,14802.4870274277
<at><openparen>77033<closeparen>,"<center><table><tr><th colspan='2' align='center'><em>Attributes</em></th></tr><tr bgcolor=""#E3E3F3""> <th>ZCTA5CE20</th> <td>77033</td> </tr><tr bgcolor=""""> <th>AFFGEOID20</th> <td>860Z200US77033</td> </tr><tr bgcolor=""#E3E3F3""> <th>GEOID20</th> <td>77033</td> </tr><tr bgcolor=""""> <th>NAME20</th> <td>77033</td> </tr><tr bgcolor=""#E3E3F3""> <th>LSAD20</th> <td>Z5</td> </tr><tr bgcolor=""""> <th>ALAND20</th> <td>14785836</td> </tr><tr bgcolor=""#E3E3F3""> <th>AWATER20</th> <td>26261</td> </tr></table></center>",77033,14785836,26261,"28369",3653.5300222387,6.48900420064245,14812097,3660.01902643934
<at><openparen>77034<closeparen>,"<center><table><tr><th colspan='2' align='center'><em>Attributes</em></th></tr><tr bgcolor=""#E3E3F3""> <th>ZCTA5CE20</th> <td>77034</td> </tr><tr bgcolor=""""> <th>AFFGEOID20</th> <td>860Z200US77034</td> </tr><tr bgcolor=""#E3E3F3""> <th>GEOID20</th> <td>77034</td> </tr><tr bgcolor=""""> <th>NAME20</th> <td>77034</td> </tr><tr bgcolor=""#E3E3F3""> <th>LSAD20</th> <td>Z5</td> </tr><tr bgcolor=""""> <th>ALAND20</th> <td>36756733</td> </tr><tr bgcolor=""#E3E3F3""> <th>AWATER20</th> <td>542139</td> </tr></table></center>",77034,36756733,542139,"38186",9082.46429453916,133.960711638251,37298872,9216.42500617741
<at><openparen>77035<closeparen>,"<center><table><tr><th colspan='2' align='center'><em>Attributes</em></th></tr><tr bgcolor=""#E3E3F3""> <th>ZCTA5CE20</th> <td>77035</td> </tr><tr bgcolor=""""> <th>AFFGEOID20</th> <td>860Z200US77035</td> </tr><tr bgcolor=""#E3E3F3""> <th>GEOID20</th> <td>77035</td> </tr><tr bgcolor=""""> <th>NAME20</th> <td>77035</td> </tr><tr bgcolor=""#E3E3F3""> <th>LSAD20</th> <td>Z5</td> </tr><tr bgcolor=""""> <th>ALAND20</th> <td>14611321</td> </tr><tr bgcolor=""#E3E3F3""> <th>AWATER20</th> <td>4881</td> </tr></table></center>",77035,14611321,4881,"37417",3610.407956511,1.2060785767235,14616202,3611.61403508772
<at><openparen>77036<closeparen>,"<center><table><tr><th colspan='2' align='center'><em>Attributes</em></th></tr><tr bgcolor=""#E3E3F3""> <th>ZCTA5CE20</th> <td>77036</td> </tr><tr bgcolor=""""> <th>AFFGEOID20</th> <td>860Z200US77036</td> </tr><tr bgcolor=""#E3E3F3""> <th>GEOID20</th> <td>77036</td> </tr><tr bgcolor=""""> <th>NAME20</th> <td>77036</td> </tr><tr bgcolor=""#E3E3F3""> <th>LSAD20</th> <td>Z5</td> </tr><tr bgcolor=""""> <th>ALAND20</th> <td>18841441</td> </tr><tr bgcolor=""#E3E3F3""> <th>AWATER20</th> <td>99655</td> </tr></table></center>",77036,18841441,99655,"75870",4655.65628860885,24.6244131455399,18941096,4680.28070175439
<at><openparen>77037<closeparen>,"<center><table><tr><th colspan='2' align='center'><em>Attributes</em></th></tr><tr bgcolor=""#E3E3F3""> <th>ZCTA5CE20</th> <td>77037</td> </tr><tr bgcolor=""""> <th>AFFGEOID20</th> <td>860Z200US77037</td> </tr><tr bgcolor=""#E3E3F3""> <th>GEOID20</th> <td>77037</td> </tr><tr bgcolor=""""> <th>NAME20</th> <td>77037</td> </tr><tr bgcolor=""#E3E3F3""> <th>LSAD20</th> <td>Z5</td> </tr><tr bgcolor=""""> <th>ALAND20</th> <td>15944156</td> </tr><tr bgcolor=""#E3E3F3""> <th>AWATER20</th> <td>23593</td> </tr></table></center>",77037,15944156,23593,"19569",3939.74697306647,5.82975043241908,15967749,3945.57672349889
<at><openparen>77038<closeparen>,"<center><table><tr><th colspan='2' align='center'><em>Attributes</em></th></tr><tr bgcolor=""#E3E3F3""> <th>ZCTA5CE20</th> <td>77038</td> </tr><tr bgcolor=""""> <th>AFFGEOID20</th> <td>860Z200US77038</td> </tr><tr bgcolor=""#E3E3F3""> <th>GEOID20</th> <td>77038</td> </tr><tr bgcolor=""""> <th>NAME20</th> <td>77038</td> </tr><tr bgcolor=""#E3E3F3""> <th>LSAD20</th> <td>Z5</td> </tr><tr bgcolor=""""> <th>ALAND20</th> <td>25124189</td> </tr><tr bgcolor=""#E3E3F3""> <th>AWATER20</th> <td>185174</td> </tr></table></center>",77038,25124189,185174,"30483",6208.1020509019,45.7558685446009,25309363,6253.8579194465
<at><openparen>77039<closeparen>,"<center><table><tr><th colspan='2' align='center'><em>Attributes</em></th></tr><tr bgcolor=""#E3E3F3""> <th>ZCTA5CE20</th> <td>77039</td> </tr><tr bgcolor=""""> <th>AFFGEOID20</th> <td>860Z200US77039</td> </tr><tr bgcolor=""#E3E3F3""> <th>GEOID20</th> <td>77039</td> </tr><tr bgcolor=""""> <th>NAME20</th> <td>77039</td> </tr><tr bgcolor=""#E3E3F3""> <th>LSAD20</th> <td>Z5</td> </tr><tr bgcolor=""""> <th>ALAND20</th> <td>26144046</td> </tr><tr bgcolor=""#E3E3F3""> <th>AWATER20</th> <td>109066</td> </tr></table></center>",77039,26144046,109066,"28740",6460.1052631579,26.9498393872004,26253112,6487.05510254509
<at><openparen>77040<closeparen>,"<center><table><tr><th colspan='2' align='center'><em>Attributes</em></th></tr><tr bgcolor=""#E3E3F3""> <th>ZCTA5CE20</th> <td>77040</td> </tr><tr bgcolor=""""> <th>AFFGEOID20</th> <td>860Z200US77040</td> </tr><tr bgcolor=""#E3E3F3""> <th>GEOID20</th> <td>77040</td> </tr><tr bgcolor=""""> <th>NAME20</th> <td>77040</td> </tr><tr bgcolor=""#E3E3F3""> <th>LSAD20</th> <td>Z5</td> </tr><tr bgcolor=""""> <th>ALAND20</th> <td>35857760</td> </tr><tr bgcolor=""#E3E3F3""> <th>AWATER20</th> <td>214716</td> </tr></table></center>",77040,35857760,214716,"49524",8860.3311094638,53.0555967383247,36072476,8913.38670620213
<at><openparen>77041<closeparen>,"<center><table><tr><th colspan='2' align='center'><em>Attributes</em></th></tr><tr bgcolor=""#E3E3F3""> <th>ZCTA5CE20</th> <td>77041</td> </tr><tr bgcolor=""""> <th>AFFGEOID20</th> <td>860Z200US77041</td> </tr><tr bgcolor=""#E3E3F3""> <th>GEOID20</th> <td>77041</td> </tr><tr bgcolor=""""> <th>NAME20</th> <td>77041</td> </tr><tr bgcolor=""#E3E3F3""> <th>LSAD20</th> <td>Z5</td> </tr><tr bgcolor=""""> <th>ALAND20</th> <td>48890066</td> </tr><tr bgcolor=""#E3E3F3""> <th>AWATER20</th> <td>434626</td> </tr></table></center>",77041,48890066,434626,"35958",12080.5698047937,107.394613293798,49324692,12187.9644180875
<at><openparen>77042<closeparen>,"<center><table><tr><th colspan='2' align='center'><em>Attributes</em></th></tr><tr bgcolor=""#E3E3F3""> <th>ZCTA5CE20</th> <td>77042</td> </tr><tr bgcolor=""""> <th>AFFGEOID20</th> <td>860Z200US77042</td> </tr><tr bgcolor=""#E3E3F3""> <th>GEOID20</th> <td>77042</td> </tr><tr bgcolor=""""> <th>NAME20</th> <td>77042</td> </tr><tr bgcolor=""#E3E3F3""> <th>LSAD20</th> <td>Z5</td> </tr><tr bgcolor=""""> <th>ALAND20</th> <td>15973596</td> </tr><tr bgcolor=""#E3E3F3""> <th>AWATER20</th> <td>96047</td> </tr></table></center>",77042,15973596,96047,"41177",3947.02149740549,23.7328885594267,16069643,3970.75438596491
<at><openparen>77043<closeparen>,"<center><table><tr><th colspan='2' align='center'><em>Attributes</em></th></tr><tr bgcolor=""#E3E3F3""> <th>ZCTA5CE20</th> <td>77043</td> </tr><tr bgcolor=""""> <th>AFFGEOID20</th> <td>860Z200US77043</td> </tr><tr bgcolor=""#E3E3F3""> <th>GEOID20</th> <td>77043</td> </tr><tr bgcolor=""""> <th>NAME20</th> <td>77043</td> </tr><tr bgcolor=""#E3E3F3""> <th>LSAD20</th> <td>Z5</td> </tr><tr bgcolor=""""> <th>ALAND20</th> <td>36681906</td> </tr><tr bgcolor=""#E3E3F3""> <th>AWATER20</th> <td>19271</td> </tr></table></center>",77043,36681906,19271,"26281",9063.97479614529,4.76179886335557,36701177,9068.73659500865
<at><openparen>77044<closeparen>,"<center><table><tr><th colspan='2' align='center'><em>Attributes</em></th></tr><tr bgcolor=""#E3E3F3""> <th>ZCTA5CE20</th> <td>77044</td> </tr><tr bgcolor=""""> <th>AFFGEOID20</th> <td>860Z200US77044</td> </tr><tr bgcolor=""#E3E3F3""> <th>GEOID20</th> <td>77044</td> </tr><tr bgcolor=""""> <th>NAME20</th> <td>77044</td> </tr><tr bgcolor=""#E3E3F3""> <th>LSAD20</th> <td>Z5</td> </tr><tr bgcolor=""""> <th>ALAND20</th> <td>101257280</td> </tr><tr bgcolor=""#E3E3F3""> <th>AWATER20</th> <td>19516586</td> </tr></table></center>",77044,101257280,19516586,"55665",25020.3311094638,4822.48233259204,120773866,29842.8134420558
<at><openparen>77045<closeparen>,"<center><table><tr><th colspan='2' align='center'><em>Attributes</em></th></tr><tr bgcolor=""#E3E3F3""> <th>ZCTA5CE20</th> <td>77045</td> </tr><tr bgcolor=""""> <th>AFFGEOID20</th> <td>860Z200US77045</td> </tr><tr bgcolor=""#E3E3F3""> <th>GEOID20</th> <td>77045</td> </tr><tr bgcolor=""""> <th>NAME20</th> <td>77045</td> </tr><tr bgcolor=""#E3E3F3""> <th>LSAD20</th> <td>Z5</td> </tr><tr bgcolor=""""> <th>ALAND20</th> <td>28881679</td> </tr><tr bgcolor=""#E3E3F3""> <th>AWATER20</th> <td>345792</td> </tr></table></center>",77045,28881679,345792,"32411",7136.56510995799,85.4440326167531,29227471,7222.00914257475
<at><openparen>77046<closeparen>,"<center><table><tr><th colspan='2' align='center'><em>Attributes</em></th></tr><tr bgcolor=""#E3E3F3""> <th>ZCTA5CE20</th> <td>77046</td> </tr><tr bgcolor=""""> <th>AFFGEOID20</th> <td>860Z200US77046</td> </tr><tr bgcolor=""#E3E3F3""> <th>GEOID20</th> <td>77046</td> </tr><tr bgcolor=""""> <th>NAME20</th> <td>77046</td> </tr><tr bgcolor=""#E3E3F3""> <th>LSAD20</th> <td>Z5</td> </tr><tr bgcolor=""""> <th>ALAND20</th> <td>277413</td> </tr><tr bgcolor=""#E3E3F3""> <th>AWATER20</th> <td>0</td> </tr></table></center>",77046,277413,0,"1742",68.5478131949592,0,277413,68.5478131949592
<at><openparen>77047<closeparen>,"<center><table><tr><th colspan='2' align='center'><em>Attributes</em></th></tr><tr bgcolor=""#E3E3F3""> <th>ZCTA5CE20</th> <td>77047</td> </tr><tr bgcolor=""""> <th>AFFGEOID20</th> <td>860Z200US77047</td> </tr><tr bgcolor=""#E3E3F3""> <th>GEOID20</th> <td>77047</td> </tr><tr bgcolor=""""> <th>NAME20</th> <td>77047</td> </tr><tr bgcolor=""#E3E3F3""> <th>LSAD20</th> <td>Z5</td> </tr><tr bgcolor=""""> <th>ALAND20</th> <td>35746080</td> </tr><tr bgcolor=""#E3E3F3""> <th>AWATER20</th> <td>598666</td> </tr></table></center>",77047,35746080,598666,"32088",8832.73535952558,147.928341981715,36344746,8980.66370150729
<at><openparen>77048<closeparen>,"<center><table><tr><th colspan='2' align='center'><em>Attributes</em></th></tr><tr bgcolor=""#E3E3F3""> <th>ZCTA5CE20</th> <td>77048</td> </tr><tr bgcolor=""""> <th>AFFGEOID20</th> <td>860Z200US77048</td> </tr><tr bgcolor=""#E3E3F3""> <th>GEOID20</th> <td>77048</td> </tr><tr bgcolor=""""> <th>NAME20</th> <td>77048</td> </tr><tr bgcolor=""#E3E3F3""> <th>LSAD20</th> <td>Z5</td> </tr><tr bgcolor=""""> <th>ALAND20</th> <td>29851500</td> </tr><tr bgcolor=""#E3E3F3""> <th>AWATER20</th> <td>236349</td> </tr></table></center>",77048,29851500,236349,"20536",7376.20459599703,58.4010378057821,30087849,7434.60563380282
<at><openparen>77049<closeparen>,"<center><table><tr><th colspan='2' align='center'><em>Attributes</em></th></tr><tr bgcolor=""#E3E3F3""> <th>ZCTA5CE20</th> <td>77049</td> </tr><tr bgcolor=""""> <th>AFFGEOID20</th> <td>860Z200US77049</td> </tr><tr bgcolor=""#E3E3F3""> <th>GEOID20</th> <td>77049</td> </tr><tr bgcolor=""""> <th>NAME20</th> <td>77049</td> </tr><tr bgcolor=""#E3E3F3""> <th>LSAD20</th> <td>Z5</td> </tr><tr bgcolor=""""> <th>ALAND20</th> <td>62679280</td> </tr><tr bgcolor=""#E3E3F3""> <th>AWATER20</th> <td>2622612</td> </tr></table></center>",77049,62679280,2622612,"38788",15487.8379046207,648.038547071905,65301892,16135.8764516926
<at><openparen>77050<closeparen>,"<center><table><tr><th colspan='2' align='center'><em>Attributes</em></th></tr><tr bgcolor=""#E3E3F3""> <th>ZCTA5CE20</th> <td>77050</td> </tr><tr bgcolor=""""> <th>AFFGEOID20</th> <td>860Z200US77050</td> </tr><tr bgcolor=""#E3E3F3""> <th>GEOID20</th> <td>77050</td> </tr><tr bgcolor=""""> <th>NAME20</th> <td>77050</td> </tr><tr bgcolor=""#E3E3F3""> <th>LSAD20</th> <td>Z5</td> </tr><tr bgcolor=""""> <th>ALAND20</th> <td>17790284</td> </tr><tr bgcolor=""#E3E3F3""> <th>AWATER20</th> <td>429229</td> </tr></table></center>",77050,17790284,429229,"5004",4395.91895231035,106.06103286385,18219513,4501.9799851742
<at><openparen>77051<closeparen>,"<center><table><tr><th colspan='2' align='center'><em>Attributes</em></th></tr><tr bgcolor=""#E3E3F3""> <th>ZCTA5CE20</th> <td>77051</td> </tr><tr bgcolor=""""> <th>AFFGEOID20</th> <td>860Z200US77051</td> </tr><tr bgcolor=""#E3E3F3""> <th>GEOID20</th> <td>77051</td> </tr><tr bgcolor=""""> <th>NAME20</th> <td>77051</td> </tr><tr bgcolor=""#E3E3F3""> <th>LSAD20</th> <td>Z5</td> </tr><tr bgcolor=""""> <th>ALAND20</th> <td>19119293</td> </tr><tr bgcolor=""#E3E3F3""> <th>AWATER20</th> <td>64820</td> </tr></table></center>",77051,19119293,64820,"18323",4724.31257721769,16.0168025698048,19184113,4740.3293797875
<at><openparen>77053<closeparen>,"<center><table><tr><th colspan='2' align='center'><em>Attributes</em></th></tr><tr bgcolor=""#E3E3F3""> <th>ZCTA5CE20</th> <td>77053</td> </tr><tr bgcolor=""""> <th>AFFGEOID20</th> <td>860Z200US77053</td> </tr><tr bgcolor=""#E3E3F3""> <th>GEOID20</th> <td>77053</td> </tr><tr bgcolor=""""> <th>NAME20</th> <td>77053</td> </tr><tr bgcolor=""#E3E3F3""> <th>LSAD20</th> <td>Z5</td> </tr><tr bgcolor=""""> <th>ALAND20</th> <td>29470961</td> </tr><tr bgcolor=""#E3E3F3""> <th>AWATER20</th> <td>119730</td> </tr></table></center>",77053,29470961,119730,"30350",7282.17469730665,29.5848776871757,29590691,7311.75957499382
<at><openparen>77054<closeparen>,"<center><table><tr><th colspan='2' align='center'><em>Attributes</em></th></tr><tr bgcolor=""#E3E3F3""> <th>ZCTA5CE20</th> <td>77054</td> </tr><tr bgcolor=""""> <th>AFFGEOID20</th> <td>860Z200US77054</td> </tr><tr bgcolor=""#E3E3F3""> <th>GEOID20</th> <td>77054</td> </tr><tr bgcolor=""""> <th>NAME20</th> <td>77054</td> </tr><tr bgcolor=""#E3E3F3""> <th>LSAD20</th> <td>Z5</td> </tr><tr bgcolor=""""> <th>ALAND20</th> <td>13849193</td> </tr><tr bgcolor=""#E3E3F3""> <th>AWATER20</th> <td>50499</td> </tr></table></center>",77054,13849193,50499,"24419",3422.0887076847,12.4781319495923,13899692,3434.5668396343
<at><openparen>77055<closeparen>,"<center><table><tr><th colspan='2' align='center'><em>Attributes</em></th></tr><tr bgcolor=""#E3E3F3""> <th>ZCTA5CE20</th> <td>77055</td> </tr><tr bgcolor=""""> <th>AFFGEOID20</th> <td>860Z200US77055</td> </tr><tr bgcolor=""#E3E3F3""> <th>GEOID20</th> <td>77055</td> </tr><tr bgcolor=""""> <th>NAME20</th> <td>77055</td> </tr><tr bgcolor=""#E3E3F3""> <th>LSAD20</th> <td>Z5</td> </tr><tr bgcolor=""""> <th>ALAND20</th> <td>21719853</td> </tr><tr bgcolor=""#E3E3F3""> <th>AWATER20</th> <td>2708</td> </tr></table></center>",77055,21719853,2708,"42766",5366.90214974055,0.66913763281443,21722561,5367.57128737336
<at><openparen>77056<closeparen>,"<center><table><tr><th colspan='2' align='center'><em>Attributes</em></th></tr><tr bgcolor=""#E3E3F3""> <th>ZCTA5CE20</th> <td>77056</td> </tr><tr bgcolor=""""> <th>AFFGEOID20</th> <td>860Z200US77056</td> </tr><tr bgcolor=""#E3E3F3""> <th>GEOID20</th> <td>77056</td> </tr><tr bgcolor=""""> <th>NAME20</th> <td>77056</td> </tr><tr bgcolor=""#E3E3F3""> <th>LSAD20</th> <td>Z5</td> </tr><tr bgcolor=""""> <th>ALAND20</th> <td>8953112</td> </tr><tr bgcolor=""#E3E3F3""> <th>AWATER20</th> <td>28609</td> </tr></table></center>",77056,8953112,28609,"24115",2212.28366691376,7.06918705213739,8981721,2219.3528539659
<at><openparen>77057<closeparen>,"<center><table><tr><th colspan='2' align='center'><em>Attributes</em></th></tr><tr bgcolor=""#E3E3F3""> <th>ZCTA5CE20</th> <td>77057</td> </tr><tr bgcolor=""""> <th>AFFGEOID20</th> <td>860Z200US77057</td> </tr><tr bgcolor=""#E3E3F3""> <th>GEOID20</th> <td>77057</td> </tr><tr bgcolor=""""> <th>NAME20</th> <td>77057</td> </tr><tr bgcolor=""#E3E3F3""> <th>LSAD20</th> <td>Z5</td> </tr><tr bgcolor=""""> <th>ALAND20</th> <td>11094646</td> </tr><tr bgcolor=""#E3E3F3""> <th>AWATER20</th> <td>8379</td> </tr></table></center>",77057,11094646,8379,"43669",2741.44946874228,2.07042253521127,11103025,2743.51989127749
<at><openparen>77058<closeparen>,"<center><table><tr><th colspan='2' align='center'><em>Attributes</em></th></tr><tr bgcolor=""#E3E3F3""> <th>ZCTA5CE20</th> <td>77058</td> </tr><tr bgcolor=""""> <th>AFFGEOID20</th> <td>860Z200US77058</td> </tr><tr bgcolor=""#E3E3F3""> <th>GEOID20</th> <td>77058</td> </tr><tr bgcolor=""""> <th>NAME20</th> <td>77058</td> </tr><tr bgcolor=""#E3E3F3""> <th>LSAD20</th> <td>Z5</td> </tr><tr bgcolor=""""> <th>ALAND20</th> <td>21662085</td> </tr><tr bgcolor=""#E3E3F3""> <th>AWATER20</th> <td>2488836</td> </tr></table></center>",77058,21662085,2488836,"19442",5352.62787249815,614.98295033358,24150921,5967.61082283173
<at><openparen>77059<closeparen>,"<center><table><tr><th colspan='2' align='center'><em>Attributes</em></th></tr><tr bgcolor=""#E3E3F3""> <th>ZCTA5CE20</th> <td>77059</td> </tr><tr bgcolor=""""> <th>AFFGEOID20</th> <td>860Z200US77059</td> </tr><tr bgcolor=""#E3E3F3""> <th>GEOID20</th> <td>77059</td> </tr><tr bgcolor=""""> <th>NAME20</th> <td>77059</td> </tr><tr bgcolor=""#E3E3F3""> <th>LSAD20</th> <td>Z5</td> </tr><tr bgcolor=""""> <th>ALAND20</th> <td>23915816</td> </tr><tr bgcolor=""#E3E3F3""> <th>AWATER20</th> <td>153131</td> </tr></table></center>",77059,23915816,153131,"18568",5909.51717321473,37.8381517173215,24068947,5947.35532493205
<at><openparen>77060<closeparen>,"<center><table><tr><th colspan='2' align='center'><em>Attributes</em></th></tr><tr bgcolor=""#E3E3F3""> <th>ZCTA5CE20</th> <td>77060</td> </tr><tr bgcolor=""""> <th>AFFGEOID20</th> <td>860Z200US77060</td> </tr><tr bgcolor=""#E3E3F3""> <th>GEOID20</th> <td>77060</td> </tr><tr bgcolor=""""> <th>NAME20</th> <td>77060</td> </tr><tr bgcolor=""#E3E3F3""> <th>LSAD20</th> <td>Z5</td> </tr><tr bgcolor=""""> <th>ALAND20</th> <td>21105576</td> </tr><tr bgcolor=""#E3E3F3""> <th>AWATER20</th> <td>18231</td> </tr></table></center>",77060,21105576,18231,"42707",5215.11638250556,4.50481838398814,21123807,5219.62120088955
<at><openparen>77061<closeparen>,"<center><table><tr><th colspan='2' align='center'><em>Attributes</em></th></tr><tr bgcolor=""#E3E3F3""> <th>ZCTA5CE20</th> <td>77061</td> </tr><tr bgcolor=""""> <th>AFFGEOID20</th> <td>860Z200US77061</td> </tr><tr bgcolor=""#E3E3F3""> <th>GEOID20</th> <td>77061</td> </tr><tr bgcolor=""""> <th>NAME20</th> <td>77061</td> </tr><tr bgcolor=""#E3E3F3""> <th>LSAD20</th> <td>Z5</td> </tr><tr bgcolor=""""> <th>ALAND20</th> <td>19326822</td> </tr><tr bgcolor=""#E3E3F3""> <th>AWATER20</th> <td>121960</td> </tr></table></center>",77061,19326822,121960,"23398",4775.59229058562,30.135903138127,19448782,4805.72819372375
<at><openparen>77062<closeparen>,"<center><table><tr><th colspan='2' align='center'><em>Attributes</em></th></tr><tr bgcolor=""#E3E3F3""> <th>ZCTA5CE20</th> <td>77062</td> </tr><tr bgcolor=""""> <th>AFFGEOID20</th> <td>860Z200US77062</td> </tr><tr bgcolor=""#E3E3F3""> <th>GEOID20</th> <td>77062</td> </tr><tr bgcolor=""""> <th>NAME20</th> <td>77062</td> </tr><tr bgcolor=""#E3E3F3""> <th>LSAD20</th> <td>Z5</td> </tr><tr bgcolor=""""> <th>ALAND20</th> <td>15056188</td> </tr><tr bgcolor=""#E3E3F3""> <th>AWATER20</th> <td>48948</td> </tr></table></center>",77062,15056188,48948,"25095",3720.33308623672,12.0948851000741,15105136,3732.42797133679
<at><openparen>77063<closeparen>,"<center><table><tr><th colspan='2' align='center'><em>Attributes</em></th></tr><tr bgcolor=""#E3E3F3""> <th>ZCTA5CE20</th> <td>77063</td> </tr><tr bgcolor=""""> <th>AFFGEOID20</th> <td>860Z200US77063</td> </tr><tr bgcolor=""#E3E3F3""> <th>GEOID20</th> <td>77063</td> </tr><tr bgcolor=""""> <th>NAME20</th> <td>77063</td> </tr><tr bgcolor=""#E3E3F3""> <th>LSAD20</th> <td>Z5</td> </tr><tr bgcolor=""""> <th>ALAND20</th> <td>11581307</td> </tr><tr bgcolor=""#E3E3F3""> <th>AWATER20</th> <td>9267</td> </tr></table></center>",77063,11581307,9267,"38298",2861.70175438596,2.28984432913269,11590574,2863.9915987151
<at><openparen>77064<closeparen>,"<center><table><tr><th colspan='2' align='center'><em>Attributes</em></th></tr><tr bgcolor=""#E3E3F3""> <th>ZCTA5CE20</th> <td>77064</td> </tr><tr bgcolor=""""> <th>AFFGEOID20</th> <td>860Z200US77064</td> </tr><tr bgcolor=""#E3E3F3""> <th>GEOID20</th> <td>77064</td> </tr><tr bgcolor=""""> <th>NAME20</th> <td>77064</td> </tr><tr bgcolor=""#E3E3F3""> <th>LSAD20</th> <td>Z5</td> </tr><tr bgcolor=""""> <th>ALAND20</th> <td>38088118</td> </tr><tr bgcolor=""#E3E3F3""> <th>AWATER20</th> <td>309939</td> </tr></table></center>",77064,38088118,309939,"48243",9411.44502100321,76.5848776871757,38398057,9488.02989869039
<at><openparen>77065<closeparen>,"<center><table><tr><th colspan='2' align='center'><em>Attributes</em></th></tr><tr bgcolor=""#E3E3F3""> <th>ZCTA5CE20</th> <td>77065</td> </tr><tr bgcolor=""""> <th>AFFGEOID20</th> <td>860Z200US77065</td> </tr><tr bgcolor=""#E3E3F3""> <th>GEOID20</th> <td>77065</td> </tr><tr bgcolor=""""> <th>NAME20</th> <td>77065</td> </tr><tr bgcolor=""#E3E3F3""> <th>LSAD20</th> <td>Z5</td> </tr><tr bgcolor=""""> <th>ALAND20</th> <td>21282306</td> </tr><tr bgcolor=""#E3E3F3""> <th>AWATER20</th> <td>46256</td> </tr></table></center>",77065,21282306,46256,"37144",5258.78576723499,11.4297010130961,21328562,5270.21546824809
<at><openparen>77066<closeparen>,"<center><table><tr><th colspan='2' align='center'><em>Attributes</em></th></tr><tr bgcolor=""#E3E3F3""> <th>ZCTA5CE20</th> <td>77066</td> </tr><tr bgcolor=""""> <th>AFFGEOID20</th> <td>860Z200US77066</td> </tr><tr bgcolor=""#E3E3F3""> <th>GEOID20</th> <td>77066</td> </tr><tr bgcolor=""""> <th>NAME20</th> <td>77066</td> </tr><tr bgcolor=""#E3E3F3""> <th>LSAD20</th> <td>Z5</td> </tr><tr bgcolor=""""> <th>ALAND20</th> <td>22367623</td> </tr><tr bgcolor=""#E3E3F3""> <th>AWATER20</th> <td>43396</td> </tr></table></center>",77066,22367623,43396,"34443",5526.96392389424,10.7230046948357,22411019,5537.68692858908
<at><openparen>77067<closeparen>,"<center><table><tr><th colspan='2' align='center'><em>Attributes</em></th></tr><tr bgcolor=""#E3E3F3""> <th>ZCTA5CE20</th> <td>77067</td> </tr><tr bgcolor=""""> <th>AFFGEOID20</th> <td>860Z200US77067</td> </tr><tr bgcolor=""#E3E3F3""> <th>GEOID20</th> <td>77067</td> </tr><tr bgcolor=""""> <th>NAME20</th> <td>77067</td> </tr><tr bgcolor=""#E3E3F3""> <th>LSAD20</th> <td>Z5</td> </tr><tr bgcolor=""""> <th>ALAND20</th> <td>14712340</td> </tr><tr bgcolor=""#E3E3F3""> <th>AWATER20</th> <td>5055</td> </tr></table></center>",77067,14712340,5055,"31729",3635.36940943909,1.24907338769459,14717395,3636.61848282679
<at><openparen>77068<closeparen>,"<center><table><tr><th colspan='2' align='center'><em>Attributes</em></th></tr><tr bgcolor=""#E3E3F3""> <th>ZCTA5CE20</th> <td>77068</td> </tr><tr bgcolor=""""> <th>AFFGEOID20</th> <td>860Z200US77068</td> </tr><tr bgcolor=""#E3E3F3""> <th>GEOID20</th> <td>77068</td> </tr><tr bgcolor=""""> <th>NAME20</th> <td>77068</td> </tr><tr bgcolor=""#E3E3F3""> <th>LSAD20</th> <td>Z5</td> </tr><tr bgcolor=""""> <th>ALAND20</th> <td>9826288</td> </tr><tr bgcolor=""#E3E3F3""> <th>AWATER20</th> <td>131783</td> </tr></table></center>",77068,9826288,131783,"11764",2428.04250061774,32.5631331850754,9958071,2460.60563380282
<at><openparen>77069<closeparen>,"<center><table><tr><th colspan='2' align='center'><em>Attributes</em></th></tr><tr bgcolor=""#E3E3F3""> <th>ZCTA5CE20</th> <td>77069</td> </tr><tr bgcolor=""""> <th>AFFGEOID20</th> <td>860Z200US77069</td> </tr><tr bgcolor=""#E3E3F3""> <th>GEOID20</th> <td>77069</td> </tr><tr bgcolor=""""> <th>NAME20</th> <td>77069</td> </tr><tr bgcolor=""#E3E3F3""> <th>LSAD20</th> <td>Z5</td> </tr><tr bgcolor=""""> <th>ALAND20</th> <td>12169566</td> </tr><tr bgcolor=""#E3E3F3""> <th>AWATER20</th> <td>106569</td> </tr></table></center>",77069,12169566,106569,"19299",3007.0585618977,26.3328391401038,12276135,3033.39140103781
<at><openparen>77070<closeparen>,"<center><table><tr><th colspan='2' align='center'><em>Attributes</em></th></tr><tr bgcolor=""#E3E3F3""> <th>ZCTA5CE20</th> <td>77070</td> </tr><tr bgcolor=""""> <th>AFFGEOID20</th> <td>860Z200US77070</td> </tr><tr bgcolor=""#E3E3F3""> <th>GEOID20</th> <td>77070</td> </tr><tr bgcolor=""""> <th>NAME20</th> <td>77070</td> </tr><tr bgcolor=""#E3E3F3""> <th>LSAD20</th> <td>Z5</td> </tr><tr bgcolor=""""> <th>ALAND20</th> <td>33786534</td> </tr><tr bgcolor=""#E3E3F3""> <th>AWATER20</th> <td>310886</td> </tr></table></center>",77070,33786534,310886,"52943",8348.53817642698,76.8188781813689,34097420,8425.35705460835
<at><openparen>77071<closeparen>,"<center><table><tr><th colspan='2' align='center'><em>Attributes</em></th></tr><tr bgcolor=""#E3E3F3""> <th>ZCTA5CE20</th> <td>77071</td> </tr><tr bgcolor=""""> <th>AFFGEOID20</th> <td>860Z200US77071</td> </tr><tr bgcolor=""#E3E3F3""> <th>GEOID20</th> <td>77071</td> </tr><tr bgcolor=""""> <th>NAME20</th> <td>77071</td> </tr><tr bgcolor=""#E3E3F3""> <th>LSAD20</th> <td>Z5</td> </tr><tr bgcolor=""""> <th>ALAND20</th> <td>11643026</td> </tr><tr bgcolor=""#E3E3F3""> <th>AWATER20</th> <td>87312</td> </tr></table></center>",77071,11643026,87312,"26949",2876.95231035335,21.5744996293551,11730338,2898.5268099827
<at><openparen>77072<closeparen>,"<center><table><tr><th colspan='2' align='center'><em>Attributes</em></th></tr><tr bgcolor=""#E3E3F3""> <th>ZCTA5CE20</th> <td>77072</td> </tr><tr bgcolor=""""> <th>AFFGEOID20</th> <td>860Z200US77072</td> </tr><tr bgcolor=""#E3E3F3""> <th>GEOID20</th> <td>77072</td> </tr><tr bgcolor=""""> <th>NAME20</th> <td>77072</td> </tr><tr bgcolor=""#E3E3F3""> <th>LSAD20</th> <td>Z5</td> </tr><tr bgcolor=""""> <th>ALAND20</th> <td>19213471</td> </tr><tr bgcolor=""#E3E3F3""> <th>AWATER20</th> <td>11612</td> </tr></table></center>",77072,19213471,11612,"56271",4747.5836422041,2.8692858907833,19225083,4750.45292809489
<at><openparen>77073<closeparen>,"<center><table><tr><th colspan='2' align='center'><em>Attributes</em></th></tr><tr bgcolor=""#E3E3F3""> <th>ZCTA5CE20</th> <td>77073</td> </tr><tr bgcolor=""""> <th>AFFGEOID20</th> <td>860Z200US77073</td> </tr><tr bgcolor=""#E3E3F3""> <th>GEOID20</th> <td>77073</td> </tr><tr bgcolor=""""> <th>NAME20</th> <td>77073</td> </tr><tr bgcolor=""#E3E3F3""> <th>LSAD20</th> <td>Z5</td> </tr><tr bgcolor=""""> <th>ALAND20</th> <td>37710745</td> </tr><tr bgcolor=""#E3E3F3""> <th>AWATER20</th> <td>199631</td> </tr></table></center>",77073,37710745,199631,"46071",9318.19743019521,49.328144304423,37910376,9367.52557449963
<at><openparen>77074<closeparen>,"<center><table><tr><th colspan='2' align='center'><em>Attributes</em></th></tr><tr bgcolor=""#E3E3F3""> <th>ZCTA5CE20</th> <td>77074</td> </tr><tr bgcolor=""""> <th>AFFGEOID20</th> <td>860Z200US77074</td> </tr><tr bgcolor=""#E3E3F3""> <th>GEOID20</th> <td>77074</td> </tr><tr bgcolor=""""> <th>NAME20</th> <td>77074</td> </tr><tr bgcolor=""#E3E3F3""> <th>LSAD20</th> <td>Z5</td> </tr><tr bgcolor=""""> <th>ALAND20</th> <td>14245828</td> </tr><tr bgcolor=""#E3E3F3""> <th>AWATER20</th> <td>59812</td> </tr></table></center>",77074,14245828,59812,"40199",3520.09587348653,14.7793427230047,14305640,3534.87521620954
<at><openparen>77075<closeparen>,"<center><table><tr><th colspan='2' align='center'><em>Attributes</em></th></tr><tr bgcolor=""#E3E3F3""> <th>ZCTA5CE20</th> <td>77075</td> </tr><tr bgcolor=""""> <th>AFFGEOID20</th> <td>860Z200US77075</td> </tr><tr bgcolor=""#E3E3F3""> <th>GEOID20</th> <td>77075</td> </tr><tr bgcolor=""""> <th>NAME20</th> <td>77075</td> </tr><tr bgcolor=""#E3E3F3""> <th>LSAD20</th> <td>Z5</td> </tr><tr bgcolor=""""> <th>ALAND20</th> <td>29041194</td> </tr><tr bgcolor=""#E3E3F3""> <th>AWATER20</th> <td>428767</td> </tr></table></center>",77075,29041194,428767,"38873",7175.98072646405,105.946874227823,29469961,7281.92760069187
<at><openparen>77076<closeparen>,"<center><table><tr><th colspan='2' align='center'><em>Attributes</em></th></tr><tr bgcolor=""#E3E3F3""> <th>ZCTA5CE20</th> <td>77076</td> </tr><tr bgcolor=""""> <th>AFFGEOID20</th> <td>860Z200US77076</td> </tr><tr bgcolor=""#E3E3F3""> <th>GEOID20</th> <td>77076</td> </tr><tr bgcolor=""""> <th>NAME20</th> <td>77076</td> </tr><tr bgcolor=""#E3E3F3""> <th>LSAD20</th> <td>Z5</td> </tr><tr bgcolor=""""> <th>ALAND20</th> <td>12297429</td> </tr><tr bgcolor=""#E3E3F3""> <th>AWATER20</th> <td>1252</td> </tr></table></center>",77076,12297429,1252,"32349",3038.65307635285,0.309364961700025,12298681,3038.96244131455
<at><openparen>77077<closeparen>,"<center><table><tr><th colspan='2' align='center'><em>Attributes</em></th></tr><tr bgcolor=""#E3E3F3""> <th>ZCTA5CE20</th> <td>77077</td> </tr><tr bgcolor=""""> <th>AFFGEOID20</th> <td>860Z200US77077</td> </tr><tr bgcolor=""#E3E3F3""> <th>GEOID20</th> <td>77077</td> </tr><tr bgcolor=""""> <th>NAME20</th> <td>77077</td> </tr><tr bgcolor=""#E3E3F3""> <th>LSAD20</th> <td>Z5</td> </tr><tr bgcolor=""""> <th>ALAND20</th> <td>42840201</td> </tr><tr bgcolor=""#E3E3F3""> <th>AWATER20</th> <td>953682</td> </tr></table></center>",77077,42840201,953682,"61302",10585.6686434396,235.651593773165,43793883,10821.3202372128
<at><openparen>77078<closeparen>,"<center><table><tr><th colspan='2' align='center'><em>Attributes</em></th></tr><tr bgcolor=""#E3E3F3""> <th>ZCTA5CE20</th> <td>77078</td> </tr><tr bgcolor=""""> <th>AFFGEOID20</th> <td>860Z200US77078</td> </tr><tr bgcolor=""#E3E3F3""> <th>GEOID20</th> <td>77078</td> </tr><tr bgcolor=""""> <th>NAME20</th> <td>77078</td> </tr><tr bgcolor=""#E3E3F3""> <th>LSAD20</th> <td>Z5</td> </tr><tr bgcolor=""""> <th>ALAND20</th> <td>26646056</td> </tr><tr bgcolor=""#E3E3F3""> <th>AWATER20</th> <td>202341</td> </tr></table></center>",77078,26646056,202341,"14855",6584.15023474178,49.997776130467,26848397,6634.14801087225
<at><openparen>77079<closeparen>,"<center><table><tr><th colspan='2' align='center'><em>Attributes</em></th></tr><tr bgcolor=""#E3E3F3""> <th>ZCTA5CE20</th> <td>77079</td> </tr><tr bgcolor=""""> <th>AFFGEOID20</th> <td>860Z200US77079</td> </tr><tr bgcolor=""#E3E3F3""> <th>GEOID20</th> <td>77079</td> </tr><tr bgcolor=""""> <th>NAME20</th> <td>77079</td> </tr><tr bgcolor=""#E3E3F3""> <th>LSAD20</th> <td>Z5</td> </tr><tr bgcolor=""""> <th>ALAND20</th> <td>20034838</td> </tr><tr bgcolor=""#E3E3F3""> <th>AWATER20</th> <td>176670</td> </tr></table></center>",77079,20034838,176670,"36404",4950.54064739313,43.6545589325426,20211508,4994.19520632567
<at><openparen>77080<closeparen>,"<center><table><tr><th colspan='2' align='center'><em>Attributes</em></th></tr><tr bgcolor=""#E3E3F3""> <th>ZCTA5CE20</th> <td>77080</td> </tr><tr bgcolor=""""> <th>AFFGEOID20</th> <td>860Z200US77080</td> </tr><tr bgcolor=""#E3E3F3""> <th>GEOID20</th> <td>77080</td> </tr><tr bgcolor=""""> <th>NAME20</th> <td>77080</td> </tr><tr bgcolor=""#E3E3F3""> <th>LSAD20</th> <td>Z5</td> </tr><tr bgcolor=""""> <th>ALAND20</th> <td>16585533</td> </tr><tr bgcolor=""#E3E3F3""> <th>AWATER20</th> <td>90254</td> </tr></table></center>",77080,16585533,90254,"45428",4098.2290585619,22.3014578700272,16675787,4120.53051643193
<at><openparen>77081<closeparen>,"<center><table><tr><th colspan='2' align='center'><em>Attributes</em></th></tr><tr bgcolor=""#E3E3F3""> <th>ZCTA5CE20</th> <td>77081</td> </tr><tr bgcolor=""""> <th>AFFGEOID20</th> <td>860Z200US77081</td> </tr><tr bgcolor=""#E3E3F3""> <th>GEOID20</th> <td>77081</td> </tr><tr bgcolor=""""> <th>NAME20</th> <td>77081</td> </tr><tr bgcolor=""#E3E3F3""> <th>LSAD20</th> <td>Z5</td> </tr><tr bgcolor=""""> <th>ALAND20</th> <td>8419607</td> </tr><tr bgcolor=""#E3E3F3""> <th>AWATER20</th> <td>3242</td> </tr></table></center>",77081,8419607,3242,"48293",2080.45638744749,0.801087225105016,8422849,2081.2574746726
<at><openparen>77082<closeparen>,"<center><table><tr><th colspan='2' align='center'><em>Attributes</em></th></tr><tr bgcolor=""#E3E3F3""> <th>ZCTA5CE20</th> <td>77082</td> </tr><tr bgcolor=""""> <th>AFFGEOID20</th> <td>860Z200US77082</td> </tr><tr bgcolor=""#E3E3F3""> <th>GEOID20</th> <td>77082</td> </tr><tr bgcolor=""""> <th>NAME20</th> <td>77082</td> </tr><tr bgcolor=""#E3E3F3""> <th>LSAD20</th> <td>Z5</td> </tr><tr bgcolor=""""> <th>ALAND20</th> <td>32596493</td> </tr><tr bgcolor=""#E3E3F3""> <th>AWATER20</th> <td>409687</td> </tr></table></center>",77082,32596493,409687,"57493",8054.48307388189,101.23227081789,33006180,8155.71534469978
<at><openparen>77083<closeparen>,"<center><table><tr><th colspan='2' align='center'><em>Attributes</em></th></tr><tr bgcolor=""#E3E3F3""> <th>ZCTA5CE20</th> <td>77083</td> </tr><tr bgcolor=""""> <th>AFFGEOID20</th> <td>860Z200US77083</td> </tr><tr bgcolor=""#E3E3F3""> <th>GEOID20</th> <td>77083</td> </tr><tr bgcolor=""""> <th>NAME20</th> <td>77083</td> </tr><tr bgcolor=""#E3E3F3""> <th>LSAD20</th> <td>Z5</td> </tr><tr bgcolor=""""> <th>ALAND20</th> <td>26845882</td> </tr><tr bgcolor=""#E3E3F3""> <th>AWATER20</th> <td>64626</td> </tr></table></center>",77083,26845882,64626,"73763",6633.52656288609,15.9688658265382,26910508,6649.49542871263
<at><openparen>77084<closeparen>,"<center><table><tr><th colspan='2' align='center'><em>Attributes</em></th></tr><tr bgcolor=""#E3E3F3""> <th>ZCTA5CE20</th> <td>77084</td> </tr><tr bgcolor=""""> <th>AFFGEOID20</th> <td>860Z200US77084</td> </tr><tr bgcolor=""#E3E3F3""> <th>GEOID20</th> <td>77084</td> </tr><tr bgcolor=""""> <th>NAME20</th> <td>77084</td> </tr><tr bgcolor=""#E3E3F3""> <th>LSAD20</th> <td>Z5</td> </tr><tr bgcolor=""""> <th>ALAND20</th> <td>82193141</td> </tr><tr bgcolor=""#E3E3F3""> <th>AWATER20</th> <td>337076</td> </tr></table></center>",77084,82193141,337076,"109808",20309.6468989375,83.2903385223622,82530217,20392.9372374598
<at><openparen>77085<closeparen>,"<center><table><tr><th colspan='2' align='center'><em>Attributes</em></th></tr><tr bgcolor=""#E3E3F3""> <th>ZCTA5CE20</th> <td>77085</td> </tr><tr bgcolor=""""> <th>AFFGEOID20</th> <td>860Z200US77085</td> </tr><tr bgcolor=""#E3E3F3""> <th>GEOID20</th> <td>77085</td> </tr><tr bgcolor=""""> <th>NAME20</th> <td>77085</td> </tr><tr bgcolor=""#E3E3F3""> <th>LSAD20</th> <td>Z5</td> </tr><tr bgcolor=""""> <th>ALAND20</th> <td>14197482</td> </tr><tr bgcolor=""#E3E3F3""> <th>AWATER20</th> <td>9816</td> </tr></table></center>",77085,14197482,9816,"17785",3508.14974054855,2.42550037064492,14207298,3510.5752409192
<at><openparen>77086<closeparen>,"<center><table><tr><th colspan='2' align='center'><em>Attributes</em></th></tr><tr bgcolor=""#E3E3F3""> <th>ZCTA5CE20</th> <td>77086</td> </tr><tr bgcolor=""""> <th>AFFGEOID20</th> <td>860Z200US77086</td> </tr><tr bgcolor=""#E3E3F3""> <th>GEOID20</th> <td>77086</td> </tr><tr bgcolor=""""> <th>NAME20</th> <td>77086</td> </tr><tr bgcolor=""#E3E3F3""> <th>LSAD20</th> <td>Z5</td> </tr><tr bgcolor=""""> <th>ALAND20</th> <td>17697552</td> </tr><tr bgcolor=""#E3E3F3""> <th>AWATER20</th> <td>13632</td> </tr></table></center>",77086,17697552,13632,"29366",4373.00518902891,3.36842105263158,17711184,4376.37361008154
<at><openparen>77087<closeparen>,"<center><table><tr><th colspan='2' align='center'><em>Attributes</em></th></tr><tr bgcolor=""#E3E3F3""> <th>ZCTA5CE20</th> <td>77087</td> </tr><tr bgcolor=""""> <th>AFFGEOID20</th> <td>860Z200US77087</td> </tr><tr bgcolor=""#E3E3F3""> <th>GEOID20</th> <td>77087</td> </tr><tr bgcolor=""""> <th>NAME20</th> <td>77087</td> </tr><tr bgcolor=""#E3E3F3""> <th>LSAD20</th> <td>Z5</td> </tr><tr bgcolor=""""> <th>ALAND20</th> <td>16979206</td> </tr><tr bgcolor=""#E3E3F3""> <th>AWATER20</th> <td>92243</td> </tr></table></center>",77087,16979206,92243,"34654",4195.50432419076,22.7929330368174,17071449,4218.29725722758
<at><openparen>77088<closeparen>,"<center><table><tr><th colspan='2' align='center'><em>Attributes</em></th></tr><tr bgcolor=""#E3E3F3""> <th>ZCTA5CE20</th> <td>77088</td> </tr><tr bgcolor=""""> <th>AFFGEOID20</th> <td>860Z200US77088</td> </tr><tr bgcolor=""#E3E3F3""> <th>GEOID20</th> <td>77088</td> </tr><tr bgcolor=""""> <th>NAME20</th> <td>77088</td> </tr><tr bgcolor=""#E3E3F3""> <th>LSAD20</th> <td>Z5</td> </tr><tr bgcolor=""""> <th>ALAND20</th> <td>28746698</td> </tr><tr bgcolor=""#E3E3F3""> <th>AWATER20</th> <td>161028</td> </tr></table></center>",77088,28746698,161028,"54320",7103.21176179886,39.7894736842105,28907726,7143.00123548307
<at><openparen>77089<closeparen>,"<center><table><tr><th colspan='2' align='center'><em>Attributes</em></th></tr><tr bgcolor=""#E3E3F3""> <th>ZCTA5CE20</th> <td>77089</td> </tr><tr bgcolor=""""> <th>AFFGEOID20</th> <td>860Z200US77089</td> </tr><tr bgcolor=""#E3E3F3""> <th>GEOID20</th> <td>77089</td> </tr><tr bgcolor=""""> <th>NAME20</th> <td>77089</td> </tr><tr bgcolor=""#E3E3F3""> <th>LSAD20</th> <td>Z5</td> </tr><tr bgcolor=""""> <th>ALAND20</th> <td>33758180</td> </tr><tr bgcolor=""#E3E3F3""> <th>AWATER20</th> <td>133155</td> </tr></table></center>",77089,33758180,133155,"56994",8341.53199901161,32.9021497405486,33891335,8374.43414875216
<at><openparen>77090<closeparen>,"<center><table><tr><th colspan='2' align='center'><em>Attributes</em></th></tr><tr bgcolor=""#E3E3F3""> <th>ZCTA5CE20</th> <td>77090</td> </tr><tr bgcolor=""""> <th>AFFGEOID20</th> <td>860Z200US77090</td> </tr><tr bgcolor=""#E3E3F3""> <th>GEOID20</th> <td>77090</td> </tr><tr bgcolor=""""> <th>NAME20</th> <td>77090</td> </tr><tr bgcolor=""#E3E3F3""> <th>LSAD20</th> <td>Z5</td> </tr><tr bgcolor=""""> <th>ALAND20</th> <td>22169569</td> </tr><tr bgcolor=""#E3E3F3""> <th>AWATER20</th> <td>136659</td> </tr></table></center>",77090,22169569,136659,"42285",5478.02545095132,33.767976278725,22306228,5511.79342723005
<at><openparen>77091<closeparen>,"<center><table><tr><th colspan='2' align='center'><em>Attributes</em></th></tr><tr bgcolor=""#E3E3F3""> <th>ZCTA5CE20</th> <td>77091</td> </tr><tr bgcolor=""""> <th>AFFGEOID20</th> <td>860Z200US77091</td> </tr><tr bgcolor=""#E3E3F3""> <th>GEOID20</th> <td>77091</td> </tr><tr bgcolor=""""> <th>NAME20</th> <td>77091</td> </tr><tr bgcolor=""#E3E3F3""> <th>LSAD20</th> <td>Z5</td> </tr><tr bgcolor=""""> <th>ALAND20</th> <td>18443634</td> </tr><tr bgcolor=""#E3E3F3""> <th>AWATER20</th> <td>66779</td> </tr></table></center>",77091,18443634,66779,"28020",4557.3595255745,16.5008648381517,18510413,4573.86039041265
<at><openparen>77092<closeparen>,"<center><table><tr><th colspan='2' align='center'><em>Attributes</em></th></tr><tr bgcolor=""#E3E3F3""> <th>ZCTA5CE20</th> <td>77092</td> </tr><tr bgcolor=""""> <th>AFFGEOID20</th> <td>860Z200US77092</td> </tr><tr bgcolor=""#E3E3F3""> <th>GEOID20</th> <td>77092</td> </tr><tr bgcolor=""""> <th>NAME20</th> <td>77092</td> </tr><tr bgcolor=""#E3E3F3""> <th>LSAD20</th> <td>Z5</td> </tr><tr bgcolor=""""> <th>ALAND20</th> <td>20978146</td> </tr><tr bgcolor=""#E3E3F3""> <th>AWATER20</th> <td>74264</td> </tr></table></center>",77092,20978146,74264,"34903",5183.62886088461,18.3503829997529,21052410,5201.97924388436
<at><openparen>77093<closeparen>,"<center><table><tr><th colspan='2' align='center'><em>Attributes</em></th></tr><tr bgcolor=""#E3E3F3""> <th>ZCTA5CE20</th> <td>77093</td> </tr><tr bgcolor=""""> <th>AFFGEOID20</th> <td>860Z200US77093</td> </tr><tr bgcolor=""#E3E3F3""> <th>GEOID20</th> <td>77093</td> </tr><tr bgcolor=""""> <th>NAME20</th> <td>77093</td> </tr><tr bgcolor=""#E3E3F3""> <th>LSAD20</th> <td>Z5</td> </tr><tr bgcolor=""""> <th>ALAND20</th> <td>31105733</td> </tr><tr bgcolor=""#E3E3F3""> <th>AWATER20</th> <td>11246</td> </tr></table></center>",77093,31105733,11246,"47736",7686.12132443786,2.77884852977514,31116979,7688.90017296763
<at><openparen>77094<closeparen>,"<center><table><tr><th colspan='2' align='center'><em>Attributes</em></th></tr><tr bgcolor=""#E3E3F3""> <th>ZCTA5CE20</th> <td>77094</td> </tr><tr bgcolor=""""> <th>AFFGEOID20</th> <td>860Z200US77094</td> </tr><tr bgcolor=""#E3E3F3""> <th>GEOID20</th> <td>77094</td> </tr><tr bgcolor=""""> <th>NAME20</th> <td>77094</td> </tr><tr bgcolor=""#E3E3F3""> <th>LSAD20</th> <td>Z5</td> </tr><tr bgcolor=""""> <th>ALAND20</th> <td>8882428</td> </tr><tr bgcolor=""#E3E3F3""> <th>AWATER20</th> <td>73576</td> </tr></table></center>",77094,8882428,73576,"11150",2194.81788979491,18.1803805287868,8956004,2212.9982703237
<at><openparen>77095<closeparen>,"<center><table><tr><th colspan='2' align='center'><em>Attributes</em></th></tr><tr bgcolor=""#E3E3F3""> <th>ZCTA5CE20</th> <td>77095</td> </tr><tr bgcolor=""""> <th>AFFGEOID20</th> <td>860Z200US77095</td> </tr><tr bgcolor=""#E3E3F3""> <th>GEOID20</th> <td>77095</td> </tr><tr bgcolor=""""> <th>NAME20</th> <td>77095</td> </tr><tr bgcolor=""#E3E3F3""> <th>LSAD20</th> <td>Z5</td> </tr><tr bgcolor=""""> <th>ALAND20</th> <td>38179873</td> </tr><tr bgcolor=""#E3E3F3""> <th>AWATER20</th> <td>216754</td> </tr></table></center>",77095,38179873,216754,"71206",9434.11737089202,53.5591796392389,38396627,9487.67655053126
<at><openparen>77096<closeparen>,"<center><table><tr><th colspan='2' align='center'><em>Attributes</em></th></tr><tr bgcolor=""#E3E3F3""> <th>ZCTA5CE20</th> <td>77096</td> </tr><tr bgcolor=""""> <th>AFFGEOID20</th> <td>860Z200US77096</td> </tr><tr bgcolor=""#E3E3F3""> <th>GEOID20</th> <td>77096</td> </tr><tr bgcolor=""""> <th>NAME20</th> <td>77096</td> </tr><tr bgcolor=""#E3E3F3""> <th>LSAD20</th> <td>Z5</td> </tr><tr bgcolor=""""> <th>ALAND20</th> <td>15598301</td> </tr><tr bgcolor=""#E3E3F3""> <th>AWATER20</th> <td>148090</td> </tr></table></center>",77096,15598301,148090,"34510",3854.28737336298,36.5925376822338,15746391,3890.87991104522
<at><openparen>77098<closeparen>,"<center><table><tr><th colspan='2' align='center'><em>Attributes</em></th></tr><tr bgcolor=""#E3E3F3""> <th>ZCTA5CE20</th> <td>77098</td> </tr><tr bgcolor=""""> <th>AFFGEOID20</th> <td>860Z200US77098</td> </tr><tr bgcolor=""#E3E3F3""> <th>GEOID20</th> <td>77098</td> </tr><tr bgcolor=""""> <th>NAME20</th> <td>77098</td> </tr><tr bgcolor=""#E3E3F3""> <th>LSAD20</th> <td>Z5</td> </tr><tr bgcolor=""""> <th>ALAND20</th> <td>4565510</td> </tr><tr bgcolor=""#E3E3F3""> <th>AWATER20</th> <td>163</td> </tr></table></center>",77098,4565510,163,"15717",1128.1220657277,0.0402767482085495,4565673,1128.16234247591
<at><openparen>77099<closeparen>,"<center><table><tr><th colspan='2' align='center'><em>Attributes</em></th></tr><tr bgcolor=""#E3E3F3""> <th>ZCTA5CE20</th> <td>77099</td> </tr><tr bgcolor=""""> <th>AFFGEOID20</th> <td>860Z200US77099</td> </tr><tr bgcolor=""#E3E3F3""> <th>GEOID20</th> <td>77099</td> </tr><tr bgcolor=""""> <th>NAME20</th> <td>77099</td> </tr><tr bgcolor=""#E3E3F3""> <th>LSAD20</th> <td>Z5</td> </tr><tr bgcolor=""""> <th>ALAND20</th> <td>15874632</td> </tr><tr bgcolor=""#E3E3F3""> <th>AWATER20</th> <td>11095</td> </tr></table></center>",77099,15874632,11095,"49849",3922.56782802076,2.74153694094391,15885727,3925.3093649617
<at><openparen>77336<closeparen>,"<center><table><tr><th colspan='2' align='center'><em>Attributes</em></th></tr><tr bgcolor=""#E3E3F3""> <th>ZCTA5CE20</th> <td>77336</td> </tr><tr bgcolor=""""> <th>AFFGEOID20</th> <td>860Z200US77336</td> </tr><tr bgcolor=""#E3E3F3""> <th>GEOID20</th> <td>77336</td> </tr><tr bgcolor=""""> <th>NAME20</th> <td>77336</td> </tr><tr bgcolor=""#E3E3F3""> <th>LSAD20</th> <td>Z5</td> </tr><tr bgcolor=""""> <th>ALAND20</th> <td>92366210</td> </tr><tr bgcolor=""#E3E3F3""> <th>AWATER20</th> <td>10142232</td> </tr></table></center>",77336,92366210,10142232,"14881",22823.377810724,2506.11119347665,102508442,25329.4890042006
<at><openparen>77338<closeparen>,"<center><table><tr><th colspan='2' align='center'><em>Attributes</em></th></tr><tr bgcolor=""#E3E3F3""> <th>ZCTA5CE20</th> <td>77338</td> </tr><tr bgcolor=""""> <th>AFFGEOID20</th> <td>860Z200US77338</td> </tr><tr bgcolor=""#E3E3F3""> <th>GEOID20</th> <td>77338</td> </tr><tr bgcolor=""""> <th>NAME20</th> <td>77338</td> </tr><tr bgcolor=""#E3E3F3""> <th>LSAD20</th> <td>Z5</td> </tr><tr bgcolor=""""> <th>ALAND20</th> <td>67438933</td> </tr><tr bgcolor=""#E3E3F3""> <th>AWATER20</th> <td>2780437</td> </tr></table></center>",77338,67438933,2780437,"45031",16663.9320484309,687.036570298987,70219370,17350.9686187299
<at><openparen>77339<closeparen>,"<center><table><tr><th colspan='2' align='center'><em>Attributes</em></th></tr><tr bgcolor=""#E3E3F3""> <th>ZCTA5CE20</th> <td>77339</td> </tr><tr bgcolor=""""> <th>AFFGEOID20</th> <td>860Z200US77339</td> </tr><tr bgcolor=""#E3E3F3""> <th>GEOID20</th> <td>77339</td> </tr><tr bgcolor=""""> <th>NAME20</th> <td>77339</td> </tr><tr bgcolor=""#E3E3F3""> <th>LSAD20</th> <td>Z5</td> </tr><tr bgcolor=""""> <th>ALAND20</th> <td>41594153</td> </tr><tr bgcolor=""#E3E3F3""> <th>AWATER20</th> <td>2483285</td> </tr></table></center>",77339,41594153,2483285,"43076",10277.7744007907,613.611317024957,44077438,10891.3857178157
<at><openparen>77345<closeparen>,"<center><table><tr><th colspan='2' align='center'><em>Attributes</em></th></tr><tr bgcolor=""#E3E3F3""> <th>ZCTA5CE20</th> <td>77345</td> </tr><tr bgcolor=""""> <th>AFFGEOID20</th> <td>860Z200US77345</td> </tr><tr bgcolor=""#E3E3F3""> <th>GEOID20</th> <td>77345</td> </tr><tr bgcolor=""""> <th>NAME20</th> <td>77345</td> </tr><tr bgcolor=""#E3E3F3""> <th>LSAD20</th> <td>Z5</td> </tr><tr bgcolor=""""> <th>ALAND20</th> <td>21712999</td> </tr><tr bgcolor=""#E3E3F3""> <th>AWATER20</th> <td>5496758</td> </tr></table></center>",77345,21712999,5496758,"27258",5365.20854954287,1358.23029404497,27209757,6723.43884358784
<at><openparen>77346<closeparen>,"<center><table><tr><th colspan='2' align='center'><em>Attributes</em></th></tr><tr bgcolor=""#E3E3F3""> <th>ZCTA5CE20</th> <td>77346</td> </tr><tr bgcolor=""""> <th>AFFGEOID20</th> <td>860Z200US77346</td> </tr><tr bgcolor=""#E3E3F3""> <th>GEOID20</th> <td>77346</td> </tr><tr bgcolor=""""> <th>NAME20</th> <td>77346</td> </tr><tr bgcolor=""#E3E3F3""> <th>LSAD20</th> <td>Z5</td> </tr><tr bgcolor=""""> <th>ALAND20</th> <td>46427495</td> </tr><tr bgcolor=""#E3E3F3""> <th>AWATER20</th> <td>6626215</td> </tr></table></center>",77346,46427495,6626215,"71119",11472.0768470472,1637.31529528045,53053710,13109.3921423276
<at><openparen>77357<closeparen>,"<center><table><tr><th colspan='2' align='center'><em>Attributes</em></th></tr><tr bgcolor=""#E3E3F3""> <th>ZCTA5CE20</th> <td>77357</td> </tr><tr bgcolor=""""> <th>AFFGEOID20</th> <td>860Z200US77357</td> </tr><tr bgcolor=""#E3E3F3""> <th>GEOID20</th> <td>77357</td> </tr><tr bgcolor=""""> <th>NAME20</th> <td>77357</td> </tr><tr bgcolor=""#E3E3F3""> <th>LSAD20</th> <td>Z5</td> </tr><tr bgcolor=""""> <th>ALAND20</th> <td>173793983</td> </tr><tr bgcolor=""#E3E3F3""> <th>AWATER20</th> <td>687033</td> </tr></table></center>",77357,173793983,687033,"30339",42943.9048678033,169.763528539659,174481016,43113.668396343
<at><openparen>77365<closeparen>,"<center><table><tr><th colspan='2' align='center'><em>Attributes</em></th></tr><tr bgcolor=""#E3E3F3""> <th>ZCTA5CE20</th> <td>77365</td> </tr><tr bgcolor=""""> <th>AFFGEOID20</th> <td>860Z200US77365</td> </tr><tr bgcolor=""#E3E3F3""> <th>GEOID20</th> <td>77365</td> </tr><tr bgcolor=""""> <th>NAME20</th> <td>77365</td> </tr><tr bgcolor=""#E3E3F3""> <th>LSAD20</th> <td>Z5</td> </tr><tr bgcolor=""""> <th>ALAND20</th> <td>107152105</td> </tr><tr bgcolor=""#E3E3F3""> <th>AWATER20</th> <td>1329998</td> </tr></table></center>",77365,107152105,1329998,"42086",26476.922411663,328.638003459353,108482103,26805.5604151223
<at><openparen>77373<closeparen>,"<center><table><tr><th colspan='2' align='center'><em>Attributes</em></th></tr><tr bgcolor=""#E3E3F3""> <th>ZCTA5CE20</th> <td>77373</td> </tr><tr bgcolor=""""> <th>AFFGEOID20</th> <td>860Z200US77373</td> </tr><tr bgcolor=""#E3E3F3""> <th>GEOID20</th> <td>77373</td> </tr><tr bgcolor=""""> <th>NAME20</th> <td>77373</td> </tr><tr bgcolor=""#E3E3F3""> <th>LSAD20</th> <td>Z5</td> </tr><tr bgcolor=""""> <th>ALAND20</th> <td>61539593</td> </tr><tr bgcolor=""#E3E3F3""> <th>AWATER20</th> <td>888670</td> </tr></table></center>",77373,61539593,888670,"63413",15206.2251050161,219.587348653323,62428263,15425.8124536694
<at><openparen>77375<closeparen>,"<center><table><tr><th colspan='2' align='center'><em>Attributes</em></th></tr><tr bgcolor=""#E3E3F3""> <th>ZCTA5CE20</th> <td>77375</td> </tr><tr bgcolor=""""> <th>AFFGEOID20</th> <td>860Z200US77375</td> </tr><tr bgcolor=""#E3E3F3""> <th>GEOID20</th> <td>77375</td> </tr><tr bgcolor=""""> <th>NAME20</th> <td>77375</td> </tr><tr bgcolor=""#E3E3F3""> <th>LSAD20</th> <td>Z5</td> </tr><tr bgcolor=""""> <th>ALAND20</th> <td>91250579</td> </tr><tr bgcolor=""#E3E3F3""> <th>AWATER20</th> <td>719256</td> </tr></table></center>",77375,91250579,719256,"65365",22547.7091672844,177.725722757598,91969835,22725.434890042
<at><openparen>77379<closeparen>,"<center><table><tr><th colspan='2' align='center'><em>Attributes</em></th></tr><tr bgcolor=""#E3E3F3""> <th>ZCTA5CE20</th> <td>77379</td> </tr><tr bgcolor=""""> <th>AFFGEOID20</th> <td>860Z200US77379</td> </tr><tr bgcolor=""#E3E3F3""> <th>GEOID20</th> <td>77379</td> </tr><tr bgcolor=""""> <th>NAME20</th> <td>77379</td> </tr><tr bgcolor=""#E3E3F3""> <th>LSAD20</th> <td>Z5</td> </tr><tr bgcolor=""""> <th>ALAND20</th> <td>66876352</td> </tr><tr bgcolor=""#E3E3F3""> <th>AWATER20</th> <td>768832</td> </tr></table></center>",77379,66876352,768832,"84704",16524.9201877934,189.975784531752,67645184,16714.8959723252
<at><openparen>77388<closeparen>,"<center><table><tr><th colspan='2' align='center'><em>Attributes</em></th></tr><tr bgcolor=""#E3E3F3""> <th>ZCTA5CE20</th> <td>77388</td> </tr><tr bgcolor=""""> <th>AFFGEOID20</th> <td>860Z200US77388</td> </tr><tr bgcolor=""#E3E3F3""> <th>GEOID20</th> <td>77388</td> </tr><tr bgcolor=""""> <th>NAME20</th> <td>77388</td> </tr><tr bgcolor=""#E3E3F3""> <th>LSAD20</th> <td>Z5</td> </tr><tr bgcolor=""""> <th>ALAND20</th> <td>34673037</td> </tr><tr bgcolor=""#E3E3F3""> <th>AWATER20</th> <td>242186</td> </tr></table></center>",77388,34673037,242186,"51483",8567.59006671609,59.8433407462318,34915223,8627.43340746232
<at><openparen>77396<closeparen>,"<center><table><tr><th colspan='2' align='center'><em>Attributes</em></th></tr><tr bgcolor=""#E3E3F3""> <th>ZCTA5CE20</th> <td>77396</td> </tr><tr bgcolor=""""> <th>AFFGEOID20</th> <td>860Z200US77396</td> </tr><tr bgcolor=""#E3E3F3""> <th>GEOID20</th> <td>77396</td> </tr><tr bgcolor=""""> <th>NAME20</th> <td>77396</td> </tr><tr bgcolor=""#E3E3F3""> <th>LSAD20</th> <td>Z5</td> </tr><tr bgcolor=""""> <th>ALAND20</th> <td>64435906</td> </tr><tr bgcolor=""#E3E3F3""> <th>AWATER20</th> <td>336806</td> </tr></table></center>",77396,64435906,336806,"61058",15921.8942426489,83.2236224363726,64772712,16005.1178650852
<at><openparen>77401<closeparen>,"<center><table><tr><th colspan='2' align='center'><em>Attributes</em></th></tr><tr bgcolor=""#E3E3F3""> <th>ZCTA5CE20</th> <td>77401</td> </tr><tr bgcolor=""""> <th>AFFGEOID20</th> <td>860Z200US77401</td> </tr><tr bgcolor=""#E3E3F3""> <th>GEOID20</th> <td>77401</td> </tr><tr bgcolor=""""> <th>NAME20</th> <td>77401</td> </tr><tr bgcolor=""#E3E3F3""> <th>LSAD20</th> <td>Z5</td> </tr><tr bgcolor=""""> <th>ALAND20</th> <td>9430648</td> </tr><tr bgcolor=""#E3E3F3""> <th>AWATER20</th> <td>1966</td> </tr></table></center>",77401,9430648,1966,"17219",2330.28119594762,0.485791944650358,9432614,2330.76698789227
<at><openparen>77429<closeparen>,"<center><table><tr><th colspan='2' align='center'><em>Attributes</em></th></tr><tr bgcolor=""#E3E3F3""> <th>ZCTA5CE20</th> <td>77429</td> </tr><tr bgcolor=""""> <th>AFFGEOID20</th> <td>860Z200US77429</td> </tr><tr bgcolor=""#E3E3F3""> <th>GEOID20</th> <td>77429</td> </tr><tr bgcolor=""""> <th>NAME20</th> <td>77429</td> </tr><tr bgcolor=""#E3E3F3""> <th>LSAD20</th> <td>Z5</td> </tr><tr bgcolor=""""> <th>ALAND20</th> <td>97877454</td> </tr><tr bgcolor=""#E3E3F3""> <th>AWATER20</th> <td>1006331</td> </tr></table></center>",77429,97877454,1006331,"94176",24185.1875463306,248.660983444527,98883785,24433.8485297751
<at><openparen>77433<closeparen>,"<center><table><tr><th colspan='2' align='center'><em>Attributes</em></th></tr><tr bgcolor=""#E3E3F3""> <th>ZCTA5CE20</th> <td>77433</td> </tr><tr bgcolor=""""> <th>AFFGEOID20</th> <td>860Z200US77433</td> </tr><tr bgcolor=""#E3E3F3""> <th>GEOID20</th> <td>77433</td> </tr><tr bgcolor=""""> <th>NAME20</th> <td>77433</td> </tr><tr bgcolor=""#E3E3F3""> <th>LSAD20</th> <td>Z5</td> </tr><tr bgcolor=""""> <th>ALAND20</th> <td>152723447</td> </tr><tr bgcolor=""#E3E3F3""> <th>AWATER20</th> <td>2053943</td> </tr></table></center>",77433,152723447,2053943,"106663",37737.4467506795,507.522362243637,154777390,38244.9691129232
<at><openparen>77449<closeparen>,"<center><table><tr><th colspan='2' align='center'><em>Attributes</em></th></tr><tr bgcolor=""#E3E3F3""> <th>ZCTA5CE20</th> <td>77449</td> </tr><tr bgcolor=""""> <th>AFFGEOID20</th> <td>860Z200US77449</td> </tr><tr bgcolor=""#E3E3F3""> <th>GEOID20</th> <td>77449</td> </tr><tr bgcolor=""""> <th>NAME20</th> <td>77449</td> </tr><tr bgcolor=""#E3E3F3""> <th>LSAD20</th> <td>Z5</td> </tr><tr bgcolor=""""> <th>ALAND20</th> <td>70032095</td> </tr><tr bgcolor=""#E3E3F3""> <th>AWATER20</th> <td>314065</td> </tr></table></center>",77449,70032095,314065,"128180",17304.6936001977,77.604398319743,70346160,17382.2979985174
<at><openparen>77450<closeparen>,"<center><table><tr><th colspan='2' align='center'><em>Attributes</em></th></tr><tr bgcolor=""#E3E3F3""> <th>ZCTA5CE20</th> <td>77450</td> </tr><tr bgcolor=""""> <th>AFFGEOID20</th> <td>860Z200US77450</td> </tr><tr bgcolor=""#E3E3F3""> <th>GEOID20</th> <td>77450</td> </tr><tr bgcolor=""""> <th>NAME20</th> <td>77450</td> </tr><tr bgcolor=""#E3E3F3""> <th>LSAD20</th> <td>Z5</td> </tr><tr bgcolor=""""> <th>ALAND20</th> <td>50961773</td> </tr><tr bgcolor=""#E3E3F3""> <th>AWATER20</th> <td>940731</td> </tr></table></center>",77450,50961773,940731,"72977",12592.4815913022,232.451445515196,51902504,12824.9330368174
<at><openparen>77477<closeparen>,"<center><table><tr><th colspan='2' align='center'><em>Attributes</em></th></tr><tr bgcolor=""#E3E3F3""> <th>ZCTA5CE20</th> <td>77477</td> </tr><tr bgcolor=""""> <th>AFFGEOID20</th> <td>860Z200US77477</td> </tr><tr bgcolor=""#E3E3F3""> <th>GEOID20</th> <td>77477</td> </tr><tr bgcolor=""""> <th>NAME20</th> <td>77477</td> </tr><tr bgcolor=""#E3E3F3""> <th>LSAD20</th> <td>Z5</td> </tr><tr bgcolor=""""> <th>ALAND20</th> <td>26432178</td> </tr><tr bgcolor=""#E3E3F3""> <th>AWATER20</th> <td>132766</td> </tr></table></center>",77477,26432178,132766,"35520",6531.30170496664,32.8060291574005,26564944,6564.10773412404
<at><openparen>77489<closeparen>,"<center><table><tr><th colspan='2' align='center'><em>Attributes</em></th></tr><tr bgcolor=""#E3E3F3""> <th>ZCTA5CE20</th> <td>77489</td> </tr><tr bgcolor=""""> <th>AFFGEOID20</th> <td>860Z200US77489</td> </tr><tr bgcolor=""#E3E3F3""> <th>GEOID20</th> <td>77489</td> </tr><tr bgcolor=""""> <th>NAME20</th> <td>77489</td> </tr><tr bgcolor=""#E3E3F3""> <th>LSAD20</th> <td>Z5</td> </tr><tr bgcolor=""""> <th>ALAND20</th> <td>29260255</td> </tr><tr bgcolor=""#E3E3F3""> <th>AWATER20</th> <td>465352</td> </tr></table></center>",77489,29260255,465352,"37257",7230.10995799358,114.986903879417,29725607,7345.09686187299
<at><openparen>77493<closeparen>,"<center><table><tr><th colspan='2' align='center'><em>Attributes</em></th></tr><tr bgcolor=""#E3E3F3""> <th>ZCTA5CE20</th> <td>77493</td> </tr><tr bgcolor=""""> <th>AFFGEOID20</th> <td>860Z200US77493</td> </tr><tr bgcolor=""#E3E3F3""> <th>GEOID20</th> <td>77493</td> </tr><tr bgcolor=""""> <th>NAME20</th> <td>77493</td> </tr><tr bgcolor=""#E3E3F3""> <th>LSAD20</th> <td>Z5</td> </tr><tr bgcolor=""""> <th>ALAND20</th> <td>160027073</td> </tr><tr bgcolor=""#E3E3F3""> <th>AWATER20</th> <td>1277155</td> </tr></table></center>",77493,160027073,1277155,"51774",39542.1480108723,315.580677044724,161304228,39857.728687917
<at><openparen>77494<closeparen>,"<center><table><tr><th colspan='2' align='center'><em>Attributes</em></th></tr><tr bgcolor=""#E3E3F3""> <th>ZCTA5CE20</th> <td>77494</td> </tr><tr bgcolor=""""> <th>AFFGEOID20</th> <td>860Z200US77494</td> </tr><tr bgcolor=""#E3E3F3""> <th>GEOID20</th> <td>77494</td> </tr><tr bgcolor=""""> <th>NAME20</th> <td>77494</td> </tr><tr bgcolor=""#E3E3F3""> <th>LSAD20</th> <td>Z5</td> </tr><tr bgcolor=""""> <th>ALAND20</th> <td>98120733</td> </tr><tr bgcolor=""#E3E3F3""> <th>AWATER20</th> <td>597638</td> </tr></table></center>",77494,98120733,597638,"130872",24245.3009636768,147.674326661725,98718371,24392.9752903385
<at><openparen>77503<closeparen>,"<center><table><tr><th colspan='2' align='center'><em>Attributes</em></th></tr><tr bgcolor=""#E3E3F3""> <th>ZCTA5CE20</th> <td>77503</td> </tr><tr bgcolor=""""> <th>AFFGEOID20</th> <td>860Z200US77503</td> </tr><tr bgcolor=""#E3E3F3""> <th>GEOID20</th> <td>77503</td> </tr><tr bgcolor=""""> <th>NAME20</th> <td>77503</td> </tr><tr bgcolor=""#E3E3F3""> <th>LSAD20</th> <td>Z5</td> </tr><tr bgcolor=""""> <th>ALAND20</th> <td>16423197</td> </tr><tr bgcolor=""#E3E3F3""> <th>AWATER20</th> <td>117404</td> </tr></table></center>",77503,16423197,117404,"24956",4058.11638250556,29.0101309612058,16540601,4087.12651346677
<at><openparen>77504<closeparen>,"<center><table><tr><th colspan='2' align='center'><em>Attributes</em></th></tr><tr bgcolor=""#E3E3F3""> <th>ZCTA5CE20</th> <td>77504</td> </tr><tr bgcolor=""""> <th>AFFGEOID20</th> <td>860Z200US77504</td> </tr><tr bgcolor=""#E3E3F3""> <th>GEOID20</th> <td>77504</td> </tr><tr bgcolor=""""> <th>NAME20</th> <td>77504</td> </tr><tr bgcolor=""#E3E3F3""> <th>LSAD20</th> <td>Z5</td> </tr><tr bgcolor=""""> <th>ALAND20</th> <td>14474294</td> </tr><tr bgcolor=""#E3E3F3""> <th>AWATER20</th> <td>93537</td> </tr></table></center>",77504,14474294,93537,"25728",3576.54904867803,23.112676056338,14567831,3599.66172473437
<at><openparen>77506<closeparen>,"<center><table><tr><th colspan='2' align='center'><em>Attributes</em></th></tr><tr bgcolor=""#E3E3F3""> <th>ZCTA5CE20</th> <td>77506</td> </tr><tr bgcolor=""""> <th>AFFGEOID20</th> <td>860Z200US77506</td> </tr><tr bgcolor=""#E3E3F3""> <th>GEOID20</th> <td>77506</td> </tr><tr bgcolor=""""> <th>NAME20</th> <td>77506</td> </tr><tr bgcolor=""#E3E3F3""> <th>LSAD20</th> <td>Z5</td> </tr><tr bgcolor=""""> <th>ALAND20</th> <td>29300910</td> </tr><tr bgcolor=""#E3E3F3""> <th>AWATER20</th> <td>2893897</td> </tr></table></center>",77506,29300910,2893897,"34431",7240.15567086731,715.072152211515,32194807,7955.22782307882
<at><openparen>77520<closeparen>,"<center><table><tr><th colspan='2' align='center'><em>Attributes</em></th></tr><tr bgcolor=""#E3E3F3""> <th>ZCTA5CE20</th> <td>77520</td> </tr><tr bgcolor=""""> <th>AFFGEOID20</th> <td>860Z200US77520</td> </tr><tr bgcolor=""#E3E3F3""> <th>GEOID20</th> <td>77520</td> </tr><tr bgcolor=""""> <th>NAME20</th> <td>77520</td> </tr><tr bgcolor=""#E3E3F3""> <th>LSAD20</th> <td>Z5</td> </tr><tr bgcolor=""""> <th>ALAND20</th> <td>54471901</td> </tr><tr bgcolor=""#E3E3F3""> <th>AWATER20</th> <td>30906634</td> </tr></table></center>",77520,54471901,30906634,"38587",13459.822337534,7636.92463553249,85378535,21096.7469730665
<at><openparen>77530<closeparen>,"<center><table><tr><th colspan='2' align='center'><em>Attributes</em></th></tr><tr bgcolor=""#E3E3F3""> <th>ZCTA5CE20</th> <td>77530</td> </tr><tr bgcolor=""""> <th>AFFGEOID20</th> <td>860Z200US77530</td> </tr><tr bgcolor=""#E3E3F3""> <th>GEOID20</th> <td>77530</td> </tr><tr bgcolor=""""> <th>NAME20</th> <td>77530</td> </tr><tr bgcolor=""#E3E3F3""> <th>LSAD20</th> <td>Z5</td> </tr><tr bgcolor=""""> <th>ALAND20</th> <td>35759331</td> </tr><tr bgcolor=""#E3E3F3""> <th>AWATER20</th> <td>9391969</td> </tr></table></center>",77530,35759331,9391969,"35319",8836.00963676798,2320.72374598468,45151300,11156.7333827527
<at><openparen>77532<closeparen>,"<center><table><tr><th colspan='2' align='center'><em>Attributes</em></th></tr><tr bgcolor=""#E3E3F3""> <th>ZCTA5CE20</th> <td>77532</td> </tr><tr bgcolor=""""> <th>AFFGEOID20</th> <td>860Z200US77532</td> </tr><tr bgcolor=""#E3E3F3""> <th>GEOID20</th> <td>77532</td> </tr><tr bgcolor=""""> <th>NAME20</th> <td>77532</td> </tr><tr bgcolor=""#E3E3F3""> <th>LSAD20</th> <td>Z5</td> </tr><tr bgcolor=""""> <th>ALAND20</th> <td>213762126</td> </tr><tr bgcolor=""#E3E3F3""> <th>AWATER20</th> <td>11772667</td> </tr></table></center>",77532,213762126,11772667,"34679",52819.8977020015,2908.98616258957,225534793,55728.8838645911
<at><openparen>77536<closeparen>,"<center><table><tr><th colspan='2' align='center'><em>Attributes</em></th></tr><tr bgcolor=""#E3E3F3""> <th>ZCTA5CE20</th> <td>77536</td> </tr><tr bgcolor=""""> <th>AFFGEOID20</th> <td>860Z200US77536</td> </tr><tr bgcolor=""#E3E3F3""> <th>GEOID20</th> <td>77536</td> </tr><tr bgcolor=""""> <th>NAME20</th> <td>77536</td> </tr><tr bgcolor=""#E3E3F3""> <th>LSAD20</th> <td>Z5</td> </tr><tr bgcolor=""""> <th>ALAND20</th> <td>25439629</td> </tr><tr bgcolor=""#E3E3F3""> <th>AWATER20</th> <td>99820</td> </tr></table></center>",77536,25439629,99820,"33693",6286.04620706696,24.665184086978,25539449,6310.71139115394
<at><openparen>77545<closeparen>,"<center><table><tr><th colspan='2' align='center'><em>Attributes</em></th></tr><tr bgcolor=""#E3E3F3""> <th>ZCTA5CE20</th> <td>77545</td> </tr><tr bgcolor=""""> <th>AFFGEOID20</th> <td>860Z200US77545</td> </tr><tr bgcolor=""#E3E3F3""> <th>GEOID20</th> <td>77545</td> </tr><tr bgcolor=""""> <th>NAME20</th> <td>77545</td> </tr><tr bgcolor=""#E3E3F3""> <th>LSAD20</th> <td>Z5</td> </tr><tr bgcolor=""""> <th>ALAND20</th> <td>38032590</td> </tr><tr bgcolor=""#E3E3F3""> <th>AWATER20</th> <td>359699</td> </tr></table></center>",77545,38032590,359699,"26563",9397.72424017791,88.8804052384482,38392289,9486.60464541636
<at><openparen>77546<closeparen>,"<center><table><tr><th colspan='2' align='center'><em>Attributes</em></th></tr><tr bgcolor=""#E3E3F3""> <th>ZCTA5CE20</th> <td>77546</td> </tr><tr bgcolor=""""> <th>AFFGEOID20</th> <td>860Z200US77546</td> </tr><tr bgcolor=""#E3E3F3""> <th>GEOID20</th> <td>77546</td> </tr><tr bgcolor=""""> <th>NAME20</th> <td>77546</td> </tr><tr bgcolor=""#E3E3F3""> <th>LSAD20</th> <td>Z5</td> </tr><tr bgcolor=""""> <th>ALAND20</th> <td>70413853</td> </tr><tr bgcolor=""#E3E3F3""> <th>AWATER20</th> <td>415989</td> </tr></table></center>",77546,70413853,415989,"54670",17399.0247096615,102.789473684211,70829842,17501.8141833457
<at><openparen>77547<closeparen>,"<center><table><tr><th colspan='2' align='center'><em>Attributes</em></th></tr><tr bgcolor=""#E3E3F3""> <th>ZCTA5CE20</th> <td>77547</td> </tr><tr bgcolor=""""> <th>AFFGEOID20</th> <td>860Z200US77547</td> </tr><tr bgcolor=""#E3E3F3""> <th>GEOID20</th> <td>77547</td> </tr><tr bgcolor=""""> <th>NAME20</th> <td>77547</td> </tr><tr bgcolor=""#E3E3F3""> <th>LSAD20</th> <td>Z5</td> </tr><tr bgcolor=""""> <th>ALAND20</th> <td>9980098</td> </tr><tr bgcolor=""#E3E3F3""> <th>AWATER20</th> <td>429724</td> </tr></table></center>",77547,9980098,429724,"9627",2466.0484309365,106.183345688164,10409822,2572.23177662466
<at><openparen>77571<closeparen>,"<center><table><tr><th colspan='2' align='center'><em>Attributes</em></th></tr><tr bgcolor=""#E3E3F3""> <th>ZCTA5CE20</th> <td>77571</td> </tr><tr bgcolor=""""> <th>AFFGEOID20</th> <td>860Z200US77571</td> </tr><tr bgcolor=""#E3E3F3""> <th>GEOID20</th> <td>77571</td> </tr><tr bgcolor=""""> <th>NAME20</th> <td>77571</td> </tr><tr bgcolor=""#E3E3F3""> <th>LSAD20</th> <td>Z5</td> </tr><tr bgcolor=""""> <th>ALAND20</th> <td>96013300</td> </tr><tr bgcolor=""#E3E3F3""> <th>AWATER20</th> <td>16556130</td> </tr></table></center>",77571,96013300,16556130,"37018",23724.5614035088,4090.96367679763,112569430,27815.5250803064
<at><openparen>77598<closeparen>,"<center><table><tr><th colspan='2' align='center'><em>Attributes</em></th></tr><tr bgcolor=""#E3E3F3""> <th>ZCTA5CE20</th> <td>77598</td> </tr><tr bgcolor=""""> <th>AFFGEOID20</th> <td>860Z200US77598</td> </tr><tr bgcolor=""#E3E3F3""> <th>GEOID20</th> <td>77598</td> </tr><tr bgcolor=""""> <th>NAME20</th> <td>77598</td> </tr><tr bgcolor=""#E3E3F3""> <th>LSAD20</th> <td>Z5</td> </tr><tr bgcolor=""""> <th>ALAND20</th> <td>31697940</td> </tr><tr bgcolor=""#E3E3F3""> <th>AWATER20</th> <td>452707</td> </tr></table></center>",77598,31697940,452707,"25620",7832.45366938473,111.86236718557,32150647,7944.3160365703
